name	taxonomy_id	taxonomy_lvl	kraken_assigned_reads	added_reads	new_est_reads	fraction_total_reads
Kocuria rosea	1275	S	8654	3095	11749	0.03868
Kocuria turfanensis	388357	S	351	120	471	0.00155
Kocuria flava	446860	S	163	78	241	0.00079
Kocuria palustris	71999	S	58	20	78	0.00026
Kocuria rhizophila	72000	S	43	37	80	0.00026
Kocuria varians	1272	S	30	15	45	0.00015
Kocuria sp. KD4	2719588	S	15	12	27	0.00009
Arthrobacter antioxidans	2895818	S	2639	801	3440	0.01133
Arthrobacter sp. PGP41	2079227	S	162	68	230	0.00076
Arthrobacter sp. U41	1849032	S	161	73	234	0.00077
Arthrobacter sp. NicSoilB4	2830997	S	91	47	138	0.00045
Arthrobacter sp. FB24	290399	S	67	31	98	0.00032
Arthrobacter sp. FW305-BF8	2879617	S	67	25	92	0.00030
Arthrobacter sp. CDRTa11	2651199	S	56	11	67	0.00022
Arthrobacter sp. QXT-31	1357915	S	55	21	76	0.00025
Arthrobacter sp. DNA4	2963432	S	52	69	121	0.00040
Arthrobacter sp. 24S4-2	2575374	S	51	16	67	0.00022
Arthrobacter sp. CJ23	2972479	S	51	19	70	0.00023
Arthrobacter sp. PM3	2017685	S	50	20	70	0.00023
Arthrobacter sp. NicSoilB8	2830998	S	49	20	69	0.00023
Arthrobacter sp. UKPF54-2	2600159	S	44	34	78	0.00026
Arthrobacter sp. KBS0702	2578107	S	44	31	75	0.00025
Arthrobacter sp. PAMC25564	2565366	S	31	12	43	0.00014
Arthrobacter sp. PAMC25284	2861279	S	30	8	38	0.00013
Arthrobacter sp. PAMC 25486	1494608	S	29	5	34	0.00011
Arthrobacter sp. ATA002	2991715	S	27	7	34	0.00011
Arthrobacter sp. D5-1	1477518	S	27	31	58	0.00019
Arthrobacter sp. zg-Y815	2964616	S	27	16	43	0.00014
Arthrobacter sp. YA7-1	2987701	S	24	11	35	0.00012
Arthrobacter sp. ERGS1:01	1704044	S	24	5	29	0.00010
Arthrobacter sp. zg-Y809	2886940	S	24	13	37	0.00012
Arthrobacter sp. zg-Y453	2886935	S	23	5	28	0.00009
Arthrobacter sp. zg-Y462	2886936	S	23	7	30	0.00010
Arthrobacter sp. Helios	2828862	S	23	5	28	0.00009
Arthrobacter sp. StoSoilB20	2830995	S	22	8	30	0.00010
Arthrobacter sp. NicSoilC5	2831000	S	22	31	53	0.00017
Arthrobacter sp. NtRootA1	2830983	S	21	13	34	0.00011
Arthrobacter sp. StoSoilB5	2830992	S	19	8	27	0.00009
Arthrobacter sp. MMS18-M83	2996261	S	19	5	24	0.00008
Arthrobacter sp. FW306-2-2C-D06B	2879618	S	19	9	28	0.00009
Arthrobacter sp. FW306-06-A	2879621	S	14	153	167	0.00055
Arthrobacter sp. YN	2020486	S	13	13	26	0.00009
Arthrobacter sp. zg-Y859	2964609	S	12	12	24	0.00008
Arthrobacter sp. zg-Y1110	2886932	S	11	14	25	0.00008
Arthrobacter agilis	37921	S	1244	312	1556	0.00512
Arthrobacter crystallopoietes	37928	S	47	9	56	0.00018
Arthrobacter sulfonylureivorans	2486855	S	38	7	45	0.00015
Arthrobacter woluwensis	156980	S	32	8	40	0.00013
Arthrobacter dokdonellae	2211210	S	27	5	32	0.00011
Arthrobacter koreensis	199136	S	23	6	29	0.00010
Arthrobacter alpinus	656366	S	22	51	73	0.00024
Arthrobacter sunyaminii	2816859	S	20	9	29	0.00010
Arthrobacter jiangjiafuii	2817475	S	19	7	26	0.00009
Pseudarthrobacter sp. BIM B-2242	2772401	S	212	51	263	0.00087
Pseudarthrobacter sp. L1SW	2851598	S	133	59	192	0.00063
Pseudarthrobacter sp. NS4	2973976	S	82	21	103	0.00034
Pseudarthrobacter sp. MM222	3018929	S	51	16	67	0.00022
Pseudarthrobacter sp. NIBRBAC000502772	2590775	S	27	30	57	0.00019
Pseudarthrobacter sp. NBSH8	2596911	S	26	14	40	0.00013
Pseudarthrobacter sp. SSS035	2931399	S	16	21	37	0.00012
Pseudarthrobacter sp. NIBRBAC000502771	2590774	S	14	41	55	0.00018
Pseudarthrobacter sp. NIBRBAC000502770	2590785	S	10	26	36	0.00012
Pseudarthrobacter equi	728066	S	222	110	332	0.00109
Pseudarthrobacter phenanthrenivorans	361575	S	153	82	235	0.00077
Pseudarthrobacter chlorophenolicus	85085	S	122	50	172	0.00057
Pseudarthrobacter psychrotolerans	2697569	S	36	19	55	0.00018
Pseudarthrobacter sulfonivorans	121292	S	18	30	48	0.00016
Glutamicibacter protophormiae	37930	S	68	40	108	0.00036
Glutamicibacter arilaitensis	256701	S	62	27	89	0.00029
Glutamicibacter sp. M10	3023076	S	16	3	19	0.00006
Glutamicibacter sp. MNS18	2989817	S	12	1	13	0.00004
Glutamicibacter halophytocola	1933880	S	20	6	26	0.00009
Glutamicibacter creatinolyticus	162496	S	19	4	23	0.00008
Glutamicibacter mishrai	1775880	S	19	12	31	0.00010
Micrococcus luteus	1270	S	89	194	283	0.00093
Micrococcus sp. KD337-16	2856555	S	30	18	48	0.00016
Paenarthrobacter sp. JL.01a	2979324	S	23	6	29	0.00010
Paenarthrobacter ureafaciens	37931	S	24	46	70	0.00023
Paenarthrobacter aurescens	43663	S	23	11	34	0.00011
Sinomonas atrocyanea	37927	S	71	26	97	0.00032
Sinomonas sp. R1AF57	2020377	S	42	12	54	0.00018
Citricoccus sp. SGAir0253	2567881	S	45	14	59	0.00019
Citricoccus sp. NR2	3004095	S	17	10	27	0.00009
Rothia kristinae	37923	S	29	14	43	0.00014
Rothia mucilaginosa	43675	S	11	2	13	0.00004
Paeniglutamicibacter sp. ZC-3	2986919	S	31	5	36	0.00012
Paeniglutamicibacter sp. Y32M11	2853258	S	25	3	28	0.00009
Neomicrococcus aestuarii	556325	S	46	8	54	0.00018
Psychromicrobium lacuslunae	1618207	S	17	1	18	0.00006
Microbacterium sp. BH-3-3-3	1906742	S	126	47	173	0.00057
Microbacterium sp. 4R-513	2567934	S	70	20	90	0.00030
Microbacterium sp. LKL04	912630	S	60	22	82	0.00027
Microbacterium sp. SSW1-36	2851648	S	60	23	83	0.00027
Microbacterium sp. ABRD_28	2268461	S	44	10	54	0.00018
Microbacterium sp. cx-55	2875948	S	43	10	53	0.00017
Microbacterium sp. No. 7	1714373	S	41	22	63	0.00021
Microbacterium sp. JZ31	1906274	S	40	15	55	0.00018
Microbacterium sp. 10M-3C3	2483401	S	39	18	57	0.00019
Microbacterium sp. SL75	2995140	S	38	13	51	0.00017
Microbacterium sp. KUDC0405	2909587	S	38	10	48	0.00016
Microbacterium sp. M28	2962064	S	37	12	49	0.00016
Microbacterium sp. YJN-G	2763257	S	36	18	54	0.00018
Microbacterium sp. H1-D42	2925844	S	35	9	44	0.00014
Microbacterium sp. Clip185	3025663	S	32	15	47	0.00015
Microbacterium sp. 1.5R	1916917	S	31	126	157	0.00052
Microbacterium sp. TPU 3598	1938334	S	30	15	45	0.00015
Microbacterium sp. PM5	2014534	S	30	9	39	0.00013
Microbacterium sp. Y-01	2048898	S	30	19	49	0.00016
Microbacterium sp. NIBRBAC000506063	2734618	S	29	19	48	0.00016
Microbacterium sp. SSW1-51	2851650	S	26	12	38	0.00013
Microbacterium sp. XT11	367477	S	26	8	34	0.00011
Microbacterium sp. KUDC0406	2909588	S	26	9	35	0.00012
Microbacterium sp. A18JL241	2782166	S	26	8	34	0.00011
Microbacterium sp. CGR1	1696072	S	23	98	121	0.00040
Microbacterium sp. 1S1	2606451	S	23	16	39	0.00013
Microbacterium sp. nov. GSS16	3019890	S	19	11	30	0.00010
Microbacterium sp. MPKO10	2989818	S	18	2	20	0.00007
Microbacterium sp. Nx66	2766784	S	12	14	26	0.00009
Microbacterium sp. J1-1	2992441	S	11	30	41	0.00013
Microbacterium foliorum	104336	S	189	88	277	0.00091
Microbacterium oleivorans	273677	S	150	48	198	0.00065
Microbacterium lemovicicum	1072463	S	100	36	136	0.00045
Microbacterium pygmaeum	370764	S	75	17	92	0.00030
Microbacterium aurum	36805	S	59	30	89	0.00029
Microbacterium cremeum	2782169	S	59	21	80	0.00026
Microbacterium hominis	162426	S	56	348	404	0.00133
Microbacterium atlanticum	2782168	S	56	20	76	0.00025
Microbacterium terricola	344163	S	53	20	73	0.00024
Microbacterium esteraromaticum	57043	S	48	16	64	0.00021
Microbacterium oxydans	82380	S	44	66	110	0.00036
Microbacterium chocolatum	84292	S	42	18	60	0.00020
Microbacterium testaceum	2033	S	40	13	53	0.00017
Microbacterium luteum	2782167	S	38	19	57	0.00019
Microbacterium caowuchunii	2614638	S	36	10	46	0.00015
Microbacterium sediminis	904291	S	35	24	59	0.00019
Microbacterium lushaniae	2614639	S	35	15	50	0.00016
Microbacterium schleiferi	69362	S	31	12	43	0.00014
Microbacterium wangchenii	2541726	S	31	13	44	0.00014
Microbacterium hydrocarbonoxydans	273678	S	30	11	41	0.00013
Microbacterium azadirachtae	582680	S	29	11	40	0.00013
Microbacterium protaetiae	2509458	S	28	7	35	0.00012
Microbacterium resistens	156977	S	25	7	32	0.00011
Microbacterium oryzae	743009	S	25	9	34	0.00011
Microbacterium fandaimingii	2708079	S	16	1	17	0.00006
Microbacterium liquefaciens	33918	S	10	26	36	0.00012
Microbacterium endophyticum	1526412	S	10	0	10	0.00003
Microbacterium amylolyticum	936337	S	10	1	11	0.00004
Agrococcus sp. SCSIO52902	2933290	S	307	218	525	0.00173
Agrococcus sp. Marseille-Q4369	2810513	S	169	96	265	0.00087
Agrococcus sp. SL85	2995141	S	108	67	175	0.00058
Agrococcus sp. SGAir0287	2070347	S	71	35	106	0.00035
Agrococcus carbonis	684552	S	162	106	268	0.00088
Agrococcus jejuensis	399736	S	87	43	130	0.00043
Rathayibacter sp. VKM Ac-2804	2609257	S	105	86	191	0.00063
Rathayibacter sp. VKM Ac-2759	2609252	S	87	39	126	0.00041
Rathayibacter sp. VKM Ac-2760	2609253	S	72	41	113	0.00037
Rathayibacter sp. VKM Ac-2805	2609258	S	28	83	111	0.00037
Rathayibacter sp. VKM Ac-2762	2609254	S	27	77	104	0.00034
Rathayibacter sp. VKM Ac-2801	2609255	S	27	29	56	0.00018
Rathayibacter festucae	110937	S	229	231	460	0.00151
Rathayibacter tanaceti	1671680	S	37	13	50	0.00016
Rathayibacter tritici	33888	S	26	9	35	0.00012
Rathayibacter rathayi	33887	S	14	4	18	0.00006
Rathayibacter iranicus	59737	S	12	2	14	0.00005
Curtobacterium sp. TC1	2862880	S	96	73	169	0.00056
Curtobacterium sp. L6-1	2841594	S	41	17	58	0.00019
Curtobacterium sp. BH-2-1-1	1905847	S	39	18	57	0.00019
Curtobacterium sp. 24E2	2804758	S	32	27	59	0.00019
Curtobacterium sp. MR_MD2014	1561023	S	25	17	42	0.00014
Curtobacterium sp. YC1	2795488	S	18	10	28	0.00009
Curtobacterium sp. TXMA1	2876939	S	11	16	27	0.00009
Curtobacterium flaccumfaciens	2035	S	151	137	288	0.00095
Curtobacterium luteum	33881	S	33	12	45	0.00015
Agromyces sp. H17E-10	2932244	S	47	24	71	0.00023
Agromyces sp. LHK192	2498704	S	43	19	62	0.00020
Agromyces sp. CFWR-12	2929802	S	38	35	73	0.00024
Agromyces flavus	589382	S	56	27	83	0.00027
Agromyces soli	659012	S	40	22	62	0.00020
Agromyces marinus	1389020	S	40	21	61	0.00020
Agromyces badenianii	2080742	S	34	17	51	0.00017
Agromyces protaetiae	2509455	S	31	13	44	0.00014
Agromyces archimandritae	2781962	S	30	12	42	0.00014
Agromyces laixinhei	2585717	S	28	10	38	0.00013
Agromyces aureus	453304	S	25	10	35	0.00012
Agromyces intestinalis	2592652	S	20	18	38	0.00013
Frigoribacterium sp. SL97	2994664	S	385	126	511	0.00168
Frigoribacterium sp. NBH87	2596916	S	97	43	140	0.00046
Clavibacter michiganensis	28447	S	153	152	305	0.00100
Clavibacter phaseoli	1734031	S	100	108	208	0.00068
Clavibacter californiensis	1401995	S	19	21	40	0.00013
Clavibacter sp. A6099	2860285	S	13	15	28	0.00009
Clavibacter zhangzhiyongii	2768071	S	12	9	21	0.00007
Cryobacterium sp. LW097	1978566	S	95	42	137	0.00045
Cryobacterium sp. SO1	1897061	S	73	32	105	0.00035
Cryobacterium sp. PAMC25264	2861288	S	28	26	54	0.00018
Cryobacterium sp.	1926290	S	12	5	17	0.00006
Cryobacterium arcticum	670052	S	42	43	85	0.00028
Cryobacterium soli	2220095	S	42	31	73	0.00024
Leucobacter sp. CX169	2813744	S	21	10	31	0.00010
Leucobacter sp. H25R-14	2932245	S	19	19	38	0.00013
Leucobacter sp. NB 10	2873270	S	18	14	32	0.00011
Leucobacter sp. Psy1	2875729	S	16	6	22	0.00007
Leucobacter triazinivorans	1784719	S	32	16	48	0.00016
Leucobacter muris	1935379	S	17	12	29	0.00010
Leucobacter viscericola	2714935	S	11	1	12	0.00004
Plantibacter sp. PA-3-X8	2480625	S	59	51	110	0.00036
Plantibacter sp. M259	2583822	S	48	40	88	0.00029
Plantibacter flavus	150123	S	32	19	51	0.00017
Leifsonia sp. 21MFCrub1.1	1798223	S	27	44	71	0.00023
Leifsonia sp. PS1209	2724914	S	27	13	40	0.00013
Leifsonia sp. ZF2019	2781978	S	22	10	32	0.00011
Leifsonia shinshuensis	150026	S	37	19	56	0.00018
Leifsonia xyli	1575	S	21	4	25	0.00008
Microcella sp. MMS21-STM10	2963406	S	37	15	52	0.00017
Microcella sp. MMS21-STM26	2994972	S	10	33	43	0.00014
Microcella flavibacter	1804990	S	48	41	89	0.00029
Microcella alkaliphila	279828	S	27	7	34	0.00011
Salinibacterium sp. dk2585	2603292	S	25	8	33	0.00011
Salinibacterium sp. ZJ450	2708338	S	24	6	30	0.00010
Salinibacterium sp. ZJ70	2708084	S	23	9	32	0.00011
Salinibacterium hongtaonis	2079791	S	10	1	11	0.00004
Protaetiibacter sp. SSC-01	2759943	S	39	23	62	0.00020
Protaetiibacter intestinalis	2419774	S	25	15	40	0.00013
Protaetiibacter larvae	2592654	S	22	12	34	0.00011
Herbiconiux sp. SALV-R1	2735133	S	44	12	56	0.00018
Herbiconiux sp. L3-i23	2905871	S	33	11	44	0.00014
Microterricola viridarii	412690	S	72	26	98	0.00032
Marisediminicola antarctica	674079	S	62	12	74	0.00024
Frondihabitans sp. 762G35	1446794	S	31	11	42	0.00014
Frondihabitans sp. PAMC 28766	1795630	S	25	5	30	0.00010
Subtercola sp. AK-R2A1-2	2895559	S	28	4	32	0.00011
Subtercola sp. PAMC28395	2846775	S	20	3	23	0.00008
Mycetocola zhujimingii	2079792	S	25	4	29	0.00010
Mycetocola sp. JXN-3	2116510	S	13	3	16	0.00005
Homoserinibacter sp. YIM 151385	2985506	S	33	15	48	0.00016
Gulosibacter molinativorax	256821	S	16	3	19	0.00006
Gulosibacter sediminis	1729695	S	15	4	19	0.00006
Agreia sp. COWG	2773266	S	29	5	34	0.00011
Cnuibacter physcomitrellae	1619308	S	29	9	38	0.00013
Gryllotalpicola protaetiae	2419771	S	28	7	35	0.00012
Glaciihabitans sp. INWT7	2596912	S	24	3	27	0.00009
Diaminobutyricimonas sp. LJ205	2683590	S	22	6	28	0.00009
Humibacter ginsenosidimutans	2599293	S	21	5	26	0.00009
Phycicoccus sp. HDW14	2714941	S	709	400	1109	0.00365
Phycicoccus endophyticus	1690220	S	417	228	645	0.00212
Janibacter melonis	262209	S	504	244	748	0.00246
Janibacter limosus	53458	S	223	97	320	0.00105
Janibacter sp. CX7	2963431	S	104	87	191	0.00063
Janibacter sp. YB324	2761047	S	41	154	195	0.00064
Janibacter indicus	857417	S	62	166	228	0.00075
Pedococcus dokdonensis	443156	S	380	200	580	0.00191
Intrasporangium calvum	53358	S	302	115	417	0.00137
Tetrasphaera sp. HKS02	1813880	S	256	120	376	0.00124
Arsenicicoccus sp. oral taxon 190	1658671	S	206	99	305	0.00100
Ornithinimicrobium flavum	1288636	S	585	291	876	0.00288
Ornithinimicrobium sp. HY006	2508882	S	230	128	358	0.00118
Ornithinimicrobium sp. JY.X270	2934161	S	160	50	210	0.00069
Ornithinimicrobium sp. HY1793	2934158	S	134	33	167	0.00055
Ornithinimicrobium sp. INDO-MA30-4	2908651	S	14	2	16	0.00005
Ornithinimicrobium avium	2283195	S	421	165	586	0.00193
Ornithinimicrobium pratense	2593973	S	164	81	245	0.00081
Ornithinimicrobium ciconiae	2594265	S	124	36	160	0.00053
Serinicoccus profundi	1078471	S	229	113	342	0.00113
Serinicoccus chungangensis	767452	S	212	110	322	0.00106
Serinicoccus hydrothermalis	1758689	S	165	116	281	0.00093
Serinicoccus marinus	247333	S	141	105	246	0.00081
Cellulomonas sp. NS3	2973977	S	249	118	367	0.00121
Cellulomonas sp. Y8	2591145	S	84	52	136	0.00045
Cellulomonas sp. zg.Y338	2968084	S	80	36	116	0.00038
Cellulomonas sp. JZ18	2654191	S	79	51	130	0.00043
Cellulomonas sp. S1-8	2904790	S	79	44	123	0.00040
Cellulomonas sp. C5510	2871170	S	74	45	119	0.00039
Cellulomonas sp. H30R-01	2704467	S	60	55	115	0.00038
Cellulomonas sp. PSBB021	2003551	S	54	61	115	0.00038
Cellulomonas sp. zg.B89	2968083	S	53	35	88	0.00029
Cellulomonas sp. zg.Y908	2968085	S	47	39	86	0.00028
Cellulomonas sp. WB94	2173174	S	14	3	17	0.00006
Cellulomonas fengjieae	2819978	S	137	60	197	0.00065
Cellulomonas fimi	1708	S	128	161	289	0.00095
Cellulomonas gilvus	11	S	78	45	123	0.00040
Cellulomonas shaoxiangyii	2566013	S	72	45	117	0.00039
Cellulomonas taurus	2729175	S	66	27	93	0.00031
Cellulomonas flavigena	1711	S	60	37	97	0.00032
Cellulomonas dongxiuzhuiae	2819979	S	57	40	97	0.00032
Cellulomonas wangleii	2816956	S	50	41	91	0.00030
Cellulomonas iranensis	76862	S	48	35	83	0.00027
Cellulomonas palmilytica	2608402	S	48	45	93	0.00031
Actinotalea sp. JY-7876	2758442	S	148	81	229	0.00075
Paraoerskovia marina	545619	S	59	20	79	0.00026
Oerskovia sp. KBS0722	1179673	S	46	20	66	0.00022
Pseudactinotalea sp. HY158	2654547	S	33	7	40	0.00013
Cellulosimicrobium cellulans	1710	S	84	170	254	0.00084
Cellulosimicrobium protaetiae	2587808	S	32	24	56	0.00018
Xylanimonas protaetiae	2509457	S	45	28	73	0.00024
Xylanimonas cellulosilytica	186189	S	41	20	61	0.00020
Xylanimonas allomyrinae	2509459	S	40	17	57	0.00019
Isoptericola variabilis	139208	S	70	49	119	0.00039
Isoptericola dokdonensis	372663	S	38	19	57	0.00019
Brachybacterium sp. Z12	2759167	S	43	13	56	0.00018
Brachybacterium sp. P6-10-X1	1903186	S	30	7	37	0.00012
Brachybacterium sp. NBEC-018	2996004	S	19	29	48	0.00016
Brachybacterium sp. SGAir0954	2571029	S	10	18	28	0.00009
Brachybacterium saurashtrense	556288	S	41	16	57	0.00019
Brachybacterium ginsengisoli	1331682	S	41	16	57	0.00019
Brachybacterium huguangmaarense	1652028	S	41	21	62	0.00020
Brachybacterium faecium	43669	S	38	16	54	0.00018
Brachybacterium vulturis	2017484	S	36	18	54	0.00018
Brachybacterium avium	2017485	S	29	13	42	0.00014
Brachybacterium halotolerans	2795215	S	16	17	33	0.00011
Brachybacterium kimchii	2942909	S	14	14	28	0.00009
Brevibacterium sp. CS2	2575923	S	57	23	80	0.00026
Brevibacterium sp. BRM-1	2999062	S	31	19	50	0.00016
Brevibacterium sp. BDJS002	3020906	S	14	42	56	0.00018
Brevibacterium sp. SMBL_HHYL_HB1	2777556	S	13	2	15	0.00005
Brevibacterium sp. WHS-Z9	2909672	S	11	3	14	0.00005
Brevibacterium linens	1703	S	43	23	66	0.00022
Brevibacterium aurantiacum	273384	S	26	50	76	0.00025
Brevibacterium casei	33889	S	24	12	36	0.00012
Brevibacterium sandarakinum	629680	S	19	3	22	0.00007
Brevibacterium luteolum	199591	S	16	5	21	0.00007
Brevibacterium pigmentatum	1496080	S	13	7	20	0.00007
Brevibacterium zhoupengii	2898795	S	11	2	13	0.00004
Brevibacterium oceani	358099	S	10	2	12	0.00004
Dermacoccus nishinomiyaensis	1274	S	72	35	107	0.00035
Dermacoccus sp. PAMC28757	2762331	S	50	22	72	0.00024
Allobranchiibius sp. GilTou73	2904523	S	98	30	128	0.00042
Luteipulveratus mongoliensis	571913	S	91	19	110	0.00036
Yimella sp. cx-51	2770551	S	62	35	97	0.00032
Georgenia yuyongxinii	2589797	S	85	29	114	0.00038
Georgenia sp. TF02-10	2917725	S	83	41	124	0.00041
Georgenia faecalis	2483799	S	57	23	80	0.00026
Georgenia wutianyii	2585135	S	53	24	77	0.00025
Ruania suaedae	2897774	S	44	14	58	0.00019
Ruania zhangjianzhongii	2603206	S	42	6	48	0.00016
Ruania alkalisoli	2779775	S	23	6	29	0.00010
Ruania halotolerans	2897773	S	13	3	16	0.00005
Occultella kanbiaonis	2675754	S	88	18	106	0.00035
Sanguibacter keddieii	60920	S	119	45	164	0.00054
Sanguibacter sp. HDW7	2714931	S	39	15	54	0.00018
Pengzhenrongella sicca	2819238	S	111	42	153	0.00050
Luteimicrobium xylanilyticum	1133546	S	44	17	61	0.00020
Miniimonas sp. S16	2171623	S	73	47	120	0.00040
Beutenbergia cavernae	84757	S	67	17	84	0.00028
Gephyromycinifex aptenodytis	2716227	S	49	7	56	0.00018
Austwickia chelonae	100225	S	28	2	30	0.00010
Kytococcus sedentarius	1276	S	81	31	112	0.00037
Demequina sp. TMPB413	2881056	S	22	2	24	0.00008
Nocardioides sp. S5	2017486	S	2709	1918	4627	0.01523
Nocardioides sp. zg-1228	2763008	S	1253	817	2070	0.00682
Nocardioides sp. HDW12B	2714939	S	1085	490	1575	0.00519
Nocardioides sp. CF8	110319	S	482	333	815	0.00268
Nocardioides sp. cx-173	2898796	S	420	223	643	0.00212
Nocardioides sp. S-1144	2582905	S	363	206	569	0.00187
Nocardioides sp. B-3	2895565	S	333	129	462	0.00152
Nocardioides sp. JS614	196162	S	300	438	738	0.00243
Nocardioides sp. InS609-2	2760705	S	298	107	405	0.00133
Nocardioides sp. W7	2931390	S	288	147	435	0.00143
Nocardioides sp. zg-579	2663857	S	271	195	466	0.00153
Nocardioides sp. LMS-CY	2840457	S	254	129	383	0.00126
Nocardioides sp. TF02-7	2917724	S	220	117	337	0.00111
Nocardioides sp. JQ2195	2592334	S	199	63	262	0.00086
Nocardioides sp. dk884	2662361	S	164	272	436	0.00144
Nocardioides sp. zg-536	2803858	S	162	104	266	0.00088
Nocardioides sp. WS12	2486272	S	113	33	146	0.00048
Nocardioides sp. Kera G14	2884264	S	98	30	128	0.00042
Nocardioides okcheonensis	2894081	S	1141	793	1934	0.00637
Nocardioides aquaticus	160826	S	740	367	1107	0.00364
Nocardioides seonyuensis	2518371	S	688	287	975	0.00321
Nocardioides piscis	2714938	S	544	314	858	0.00282
Nocardioides euryhalodurans	2518370	S	410	199	609	0.00201
Nocardioides panacis	2849501	S	343	157	500	0.00165
Nocardioides dongkuii	2760089	S	314	243	557	0.00183
Nocardioides anomalus	2712223	S	295	141	436	0.00144
Nocardioides ungokensis	1643322	S	294	156	450	0.00148
Nocardioides mesophilus	433659	S	257	115	372	0.00122
Nocardioides campestrisoli	2736757	S	255	130	385	0.00127
Nocardioides rotundus	1774216	S	245	130	375	0.00123
Nocardioides cynanchi	2558918	S	243	91	334	0.00110
Nocardioides dokdonensis	450734	S	243	175	418	0.00138
Nocardioides coralli	2872154	S	236	103	339	0.00112
Nocardioides marinisabuli	419476	S	233	189	422	0.00139
Nocardioides houyundeii	2045452	S	211	97	308	0.00101
Nocardioides humi	449461	S	199	113	312	0.00103
Nocardioides aromaticivorans	200618	S	190	120	310	0.00102
Nocardioides pantholopis	2483798	S	187	129	316	0.00104
Nocardioides daphniae	402297	S	152	105	257	0.00085
Nocardioides jishulii	2575440	S	148	81	229	0.00075
Nocardioides panacisoli	627624	S	147	57	204	0.00067
Nocardioides sambongensis	2589074	S	139	61	200	0.00066
Nocardioides ochotonae	2685869	S	136	209	345	0.00114
Nocardioides yefusunii	2500546	S	79	29	108	0.00036
Nocardioides baekrokdamisoli	1804624	S	49	10	59	0.00019
Aeromicrobium sp. Leaf245	1736306	S	101	40	141	0.00046
Aeromicrobium sp. HA	3009077	S	94	52	146	0.00048
Aeromicrobium sp. zg.Y1379	2969247	S	79	31	110	0.00036
Aeromicrobium sp. A1-2	2107713	S	72	15	87	0.00029
Aeromicrobium sp. zg.Y50	2968086	S	58	40	98	0.00032
Aeromicrobium sp. zg-629	2663859	S	48	32	80	0.00026
Aeromicrobium choanae	1736691	S	115	65	180	0.00059
Aeromicrobium erythreum	2041	S	87	37	124	0.00041
Aeromicrobium yanjiei	2662028	S	78	38	116	0.00038
Aeromicrobium chenweiae	2079793	S	67	35	102	0.00034
Aeromicrobium marinum	219314	S	62	20	82	0.00027
Marmoricola scoriae	642780	S	681	380	1061	0.00349
Friedmanniella luteola	546871	S	475	150	625	0.00206
Pimelobacter simplex	2045	S	281	184	465	0.00153
Micropruina glycogenica	75385	S	158	31	189	0.00062
Solicola gregarius	2908642	S	71	12	83	0.00027
Mumia sp. ZJ1417	2708082	S	67	17	84	0.00028
Tessaracoccus flavus	1610493	S	178	162	340	0.00112
Tessaracoccus defluvii	1285901	S	125	124	249	0.00082
Tessaracoccus sp. MC1865	2760310	S	107	52	159	0.00052
Tessaracoccus flavescens	399497	S	101	116	217	0.00071
Tessaracoccus aquimaris	1332264	S	94	73	167	0.00055
Tessaracoccus palaemonis	2829499	S	77	41	118	0.00039
Tessaracoccus timonensis	2161816	S	21	6	27	0.00009
Microlunatus phosphovorus	29405	S	207	36	243	0.00080
Microlunatus sagamiharensis	546874	S	205	76	281	0.00093
Microlunatus elymi	2596828	S	74	19	93	0.00031
Microlunatus soli	630515	S	61	14	75	0.00025
Microlunatus sp. Gsoil 973	2672569	S	61	12	73	0.00024
Propioniciclava sp. MC1595	2760308	S	254	131	385	0.00127
Propioniciclava coleopterorum	2714937	S	191	114	305	0.00100
Auraticoccus monumenti	675864	S	119	33	152	0.00050
Acidipropionibacterium acidipropionici	1748	S	43	32	75	0.00025
Acidipropionibacterium jensenii	1749	S	33	28	61	0.00020
Acidipropionibacterium virtanenii	2057246	S	21	7	28	0.00009
Propionibacterium freudenreichii	1744	S	35	20	55	0.00018
Propionibacterium acidifaciens	556499	S	31	16	47	0.00015
Propionibacterium australiense	119981	S	27	11	38	0.00013
Cutibacterium acnes	1747	S	40	8	48	0.00016
Cutibacterium avidum	33010	S	26	11	37	0.00012
Cutibacterium granulosum	33011	S	14	3	17	0.00006
Arachnia propionica	1750	S	38	6	44	0.00014
Arachnia rubra	1547448	S	26	5	31	0.00010
Raineyella fluvialis	2662261	S	66	12	78	0.00026
Kribbella flavida	182640	S	84	32	116	0.00038
Kribbella sp. CA-293567	3002436	S	66	23	89	0.00029
Kribbella qitaiheensis	1544730	S	64	17	81	0.00027
Actinopolymorpha singaporensis	117157	S	67	12	79	0.00026
Mycolicibacterium doricum	126673	S	2117	658	2775	0.00914
Mycolicibacterium monacense	85693	S	362	152	514	0.00169
Mycolicibacterium litorale	758802	S	134	52	186	0.00061
Mycolicibacterium arabiense	1286181	S	99	20	119	0.00039
Mycolicibacterium sediminis	1286180	S	74	18	92	0.00030
Mycolicibacterium gadium	1794	S	69	12	81	0.00027
Mycolicibacterium neoaurum	1795	S	55	14	69	0.00023
Mycolicibacterium aurum	1791	S	52	10	62	0.00020
Mycolicibacterium baixiangningiae	2761578	S	49	11	60	0.00020
Mycolicibacterium sp. YH-1	2908837	S	37	15	52	0.00017
Mycolicibacterium gilvum	1804	S	48	24	72	0.00024
Mycolicibacterium poriferae	39694	S	46	13	59	0.00019
Mycolicibacterium rhodesiae	36814	S	42	8	50	0.00016
Mycolicibacterium fortuitum	1766	S	40	17	57	0.00019
Mycolicibacterium vaccae	1810	S	40	11	51	0.00017
Mycolicibacterium austroafricanum	39687	S	39	160	199	0.00066
Mycolicibacterium psychrotolerans	216929	S	38	11	49	0.00016
Mycolicibacterium fluoranthenivorans	258505	S	38	6	44	0.00014
Mycolicibacterium chubuense	1800	S	37	16	53	0.00017
Mycolicibacterium smegmatis	1772	S	36	12	48	0.00016
Mycolicibacterium madagascariense	212765	S	33	6	39	0.00013
Mycolicibacterium rufum	318424	S	32	15	47	0.00015
Mycolicibacterium moriokaense	39691	S	32	5	37	0.00012
Mycolicibacterium phocaicum	319706	S	31	18	49	0.00016
Mycolicibacterium insubricum	444597	S	31	10	41	0.00013
Mycolicibacterium hassiacum	46351	S	30	10	40	0.00013
Mycolicibacterium mengxianglii	2736649	S	30	4	34	0.00011
Mycolicibacterium holsaticum	152142	S	30	6	36	0.00012
Mycolicibacterium chitae	1792	S	29	8	37	0.00012
Mycolicibacterium pulveris	36813	S	29	6	35	0.00012
Mycolicibacterium parafortuitum	39692	S	29	8	37	0.00012
Mycolicibacterium anyangense	1431246	S	29	6	35	0.00012
Mycolicibacterium rutilum	370526	S	28	10	38	0.00013
Mycolicibacterium goodii	134601	S	28	8	36	0.00012
Mycolicibacterium duvalii	39688	S	27	7	34	0.00011
Mycolicibacterium celeriflavum	1249101	S	27	7	34	0.00011
Mycolicibacterium mageritense	53462	S	27	6	33	0.00011
Mycolicibacterium fallax	1793	S	25	11	36	0.00012
Mycolicibacterium brumae	85968	S	24	10	34	0.00011
Mycolicibacterium phlei	1771	S	23	9	32	0.00011
Mycolicibacterium tokaiense	39695	S	23	5	28	0.00009
Mycolicibacterium thermoresistibile	1797	S	23	6	29	0.00010
Mycolicibacterium confluentis	28047	S	22	4	26	0.00009
Mycolicibacterium helvum	1534349	S	22	4	26	0.00009
Mycolicibacterium boenickei	146017	S	19	18	37	0.00012
Mycolicibacterium aichiense	1799	S	17	4	21	0.00007
Mycolicibacterium sarraceniae	1534348	S	14	2	16	0.00005
Mycolicibacterium vanbaalenii	110539	S	13	128	141	0.00046
Mycolicibacterium alvei	67081	S	12	4	16	0.00005
Mycolicibacterium mucogenicum	56689	S	11	5	16	0.00005
Mycobacterium sp. IDR2000157661	2867005	S	44	14	58	0.00019
Mycobacterium sp. JS623	212767	S	37	4	41	0.00013
Mycobacterium sp. SMC-4	2857059	S	29	22	51	0.00017
Mycobacterium sp. SMC-8	2857060	S	26	21	47	0.00015
Mycobacterium sp. MS1601	1936029	S	24	5	29	0.00010
Mycobacterium sp. DL592	2675524	S	24	6	30	0.00010
Mycobacterium sp. YC-RL4	1682113	S	22	9	31	0.00010
Mycobacterium sp. EPa45	1545728	S	17	5	22	0.00007
Mycobacterium sp. DL440	2675523	S	15	5	20	0.00007
Mycobacterium sp. SMC-2	2857058	S	12	3	15	0.00005
Mycobacterium sp. Aquia_213	2991728	S	11	4	15	0.00005
Mycobacterium florentinum	292462	S	21	8	29	0.00010
Mycobacterium parmense	185642	S	20	8	28	0.00009
Mycobacterium heidelbergense	53376	S	16	8	24	0.00008
Mycobacterium kubicae	120959	S	16	6	22	0.00007
Mycobacterium lentiflavum	141349	S	14	4	18	0.00006
Mycobacterium saskatchewanense	220927	S	14	3	17	0.00006
Mycobacterium shigaense	722731	S	14	3	17	0.00006
Mycobacterium simiae	1784	S	13	2	15	0.00005
Mycobacterium stomatepiae	470076	S	11	3	14	0.00005
Mycobacterium avium	1764	S	26	32	58	0.00019
Mycobacterium intracellulare	1767	S	14	112	126	0.00041
Mycobacterium mantenii	560555	S	14	3	17	0.00006
Mycobacterium senriense	2775496	S	13	4	17	0.00006
Mycobacterium marseillense	701042	S	12	6	18	0.00006
Mycobacterium frederiksbergense	117567	S	90	39	129	0.00042
Mycobacterium canettii	78331	S	39	37	76	0.00025
Mycobacterium diernhoferi	1801	S	34	9	43	0.00014
Mycobacterium grossiae	1552759	S	30	13	43	0.00014
Candidatus Mycobacterium methanotrophicum	2943498	S	29	3	32	0.00011
Mycobacterium branderi	43348	S	23	4	27	0.00009
Mycobacterium dioxanotrophicus	482462	S	23	8	31	0.00010
Mycobacterium cookii	1775	S	22	3	25	0.00008
Mycobacterium paragordonae	1389713	S	21	5	26	0.00009
Mycobacterium gordonae	1778	S	18	2	20	0.00007
Mycobacterium kansasii	1768	S	17	4	21	0.00007
Mycobacterium heckeshornense	110505	S	16	3	19	0.00006
Mycobacterium riyadhense	486698	S	16	1	17	0.00006
Mycobacterium conspicuum	44010	S	14	3	17	0.00006
Mycobacterium malmoense	1780	S	14	5	19	0.00006
Mycobacterium ostraviense	2738409	S	13	4	17	0.00006
Mycobacterium vicinigordonae	1719132	S	11	1	12	0.00004
Mycobacterium noviomagense	459858	S	11	1	12	0.00004
Mycobacterium heraklionense	512402	S	10	5	15	0.00005
Mycobacterium paraterrae	577492	S	10	1	11	0.00004
Mycobacterium virginiense	1795032	S	10	4	14	0.00005
Mycobacteroides chelonae	1774	S	22	8	30	0.00010
Mycobacteroides abscessus	36809	S	22	25	47	0.00015
Mycolicibacter sp. MYC340	2855503	S	12	14	26	0.00009
Mycolicibacter sp. MYC098	2872309	S	12	16	28	0.00009
Mycolicibacter hiberniae	29314	S	14	4	18	0.00006
Mycolicibacter terrae	1788	S	10	4	14	0.00005
Mycolicibacillus parakoreensis	1069221	S	29	12	41	0.00013
Mycolicibacillus koreensis	1069220	S	20	8	28	0.00009
Hoyosella subflava	639313	S	19	1	20	0.00007
Rhodococcus fascians	1828	S	2522	445	2967	0.00977
Rhodococcus sp. B7740	1564114	S	94	17	111	0.00037
Rhodococcus sp. P1Y	1302308	S	74	8	82	0.00027
Rhodococcus sp. X156	2499145	S	60	24	84	0.00028
Rhodococcus sp. 75	2987751	S	50	13	63	0.00021
Rhodococcus sp. PBTS 1	1653478	S	46	13	59	0.00019
Rhodococcus sp. MTM3W5.2	1805827	S	40	12	52	0.00017
Rhodococcus sp. Z13	2962047	S	27	11	38	0.00013
Rhodococcus sp. W8901	2742603	S	25	12	37	0.00012
Rhodococcus sp. SGAir0479	2567884	S	20	11	31	0.00010
Rhodococcus sp. ABRD24	2507582	S	19	5	24	0.00008
Rhodococcus sp. USK10	2789739	S	16	13	29	0.00010
Rhodococcus sp. WMMA185	679318	S	12	1	13	0.00004
Rhodococcus sp. USK13	2806442	S	10	26	36	0.00012
Rhodococcus erythropolis	1833	S	31	154	185	0.00061
Rhodococcus qingshengii	334542	S	25	163	188	0.00062
Rhodococcus opacus	37919	S	54	57	111	0.00037
Rhodococcus pyridinivorans	103816	S	36	166	202	0.00067
Rhodococcus coprophilus	38310	S	34	6	40	0.00013
Rhodococcus triatomae	300028	S	33	9	42	0.00014
Rhodococcus gordoniae	223392	S	20	9	29	0.00010
Rhodococcus rhodochrous	1829	S	20	30	50	0.00016
Rhodococcus globerulus	33008	S	15	1	16	0.00005
Rhodococcus jostii	132919	S	15	10	25	0.00008
Rhodococcus koreensis	99653	S	14	7	21	0.00007
Rhodococcus pseudokoreensis	2811421	S	11	7	18	0.00006
Nocardia asteroides	1824	S	121	47	168	0.00055
Nocardia brasiliensis	37326	S	58	16	74	0.00024
Nocardia cyriacigeorgica	135487	S	43	16	59	0.00019
Nocardia terpenica	455432	S	37	8	45	0.00015
Nocardia farcinica	37329	S	36	19	55	0.00018
Nocardia arthritidis	228602	S	31	5	36	0.00012
Nocardia seriolae	37332	S	31	10	41	0.00013
Nocardia wallacei	480035	S	29	9	38	0.00013
Nocardia sp. CS682	1047172	S	29	9	38	0.00013
Nocardia gipuzkoensis	2749991	S	29	12	41	0.00013
Nocardia nova	37330	S	27	4	31	0.00010
Nocardia yamanashiensis	209247	S	25	6	31	0.00010
Nocardia otitidiscaviarum	1823	S	25	6	31	0.00010
Nocardia tengchongensis	2055889	S	25	8	33	0.00011
Nocardia mangyaensis	2213200	S	25	7	32	0.00011
Nocardia huaxiensis	2755382	S	24	5	29	0.00010
Nocardia iowensis	204891	S	19	5	24	0.00008
Nocardia yunnanensis	2382165	S	18	6	24	0.00008
Prescottella equi	43767	S	32	19	51	0.00017
Dietzia kunjamensis	322509	S	781	442	1223	0.00403
Dietzia sp. B32	2915130	S	125	37	162	0.00053
Dietzia sp. oral taxon 368	712270	S	50	22	72	0.00024
Dietzia sp. DQ12-45-1b	912801	S	10	123	133	0.00044
Dietzia psychralcaliphila	139021	S	129	32	161	0.00053
Dietzia lutea	546160	S	36	13	49	0.00016
Dietzia timorensis	499555	S	19	6	25	0.00008
Corynebacterium xerosis	1725	S	105	40	145	0.00048
Corynebacterium variabile	1727	S	62	21	83	0.00027
Corynebacterium marinum	349751	S	52	16	68	0.00022
Corynebacterium stationis	1705	S	50	6	56	0.00018
Corynebacterium cyclohexanicum	322009	S	44	17	61	0.00020
Corynebacterium callunae	1721	S	43	7	50	0.00016
Corynebacterium sphenisci	191493	S	31	8	39	0.00013
Corynebacterium glutamicum	1718	S	31	156	187	0.00062
Corynebacterium casei	160386	S	30	18	48	0.00016
Corynebacterium efficiens	152794	S	24	3	27	0.00009
Corynebacterium frankenforstense	1230998	S	22	5	27	0.00009
Corynebacterium bovis	36808	S	18	3	21	0.00007
Corynebacterium maris	575200	S	17	2	19	0.00006
Corynebacterium nuruki	1032851	S	16	3	19	0.00006
Corynebacterium ureicelerivorans	401472	S	15	3	18	0.00006
Corynebacterium ihumii	1232427	S	15	3	18	0.00006
Corynebacterium flavescens	28028	S	14	1	15	0.00005
Corynebacterium humireducens	1223514	S	14	3	17	0.00006
Corynebacterium doosanense	1121358	S	13	4	17	0.00006
Corynebacterium glyciniphilum	1404244	S	13	1	14	0.00005
Corynebacterium halotolerans	225326	S	12	2	14	0.00005
Corynebacterium mycetoides	38302	S	11	3	14	0.00005
Corynebacterium liangguodongii	2079535	S	11	1	12	0.00004
Corynebacterium provencense	1737425	S	11	1	12	0.00004
Corynebacterium freneyi	134034	S	11	3	14	0.00005
Corynebacterium jeikeium	38289	S	11	14	25	0.00008
Corynebacterium tuberculostearicum	38304	S	10	2	12	0.00004
Corynebacterium comes	2675218	S	10	1	11	0.00004
Gordonia sp. SL306	2995145	S	27	3	30	0.00010
Gordonia sp. KTR9	337191	S	26	6	32	0.00011
Gordonia sp. YC-JH1	2059875	S	24	11	35	0.00012
Gordonia sp. PP30	2935861	S	24	6	30	0.00010
Gordonia sp. 135	2676309	S	23	142	165	0.00054
Gordonia sp. PDNC005	2811424	S	15	11	26	0.00009
Gordonia polyisoprenivorans	84595	S	57	11	68	0.00022
Gordonia alkanivorans	84096	S	39	146	185	0.00061
Gordonia iterans	1004901	S	29	8	37	0.00012
Gordonia terrae	2055	S	28	16	44	0.00014
Gordonia rubripertincta	36822	S	28	17	45	0.00015
Gordonia zhaorongruii	2597659	S	26	4	30	0.00010
Gordonia bronchialis	2054	S	26	5	31	0.00010
Gordonia insulae	2420509	S	25	4	29	0.00010
Gordonia phthalatica	1136941	S	23	8	31	0.00010
Gordonia otitidis	249058	S	20	3	23	0.00008
Gordonia mangrovi	2665643	S	16	2	18	0.00006
Gordonia amarae	36821	S	15	3	18	0.00006
Gordonia pseudamarae	2831662	S	13	2	15	0.00005
Gordonia amicalis	89053	S	12	83	95	0.00031
Gordonia jinghuaiqii	2758710	S	12	2	14	0.00005
Skermania piniformis	39122	S	23	3	26	0.00009
Tsukamurella paurometabola	2061	S	46	18	64	0.00021
Tsukamurella tyrosinosolvens	57704	S	33	20	53	0.00017
Tsukamurella sp. PLM1	2929795	S	25	10	35	0.00012
Tsukamurella pulmonis	47312	S	17	7	24	0.00008
Tomitella gaofuii	2760083	S	22	6	28	0.00009
Tomitella fengzijianii	2597660	S	20	6	26	0.00009
Segniliparus rotundus	286802	S	10	0	10	0.00003
Streptomyces sp. SN-593	659352	S	64	25	89	0.00029
Streptomyces sp. T12	477697	S	54	50	104	0.00034
Streptomyces sp. So13.3	2136173	S	47	16	63	0.00021
Streptomyces sp. MA3_2.13	2867410	S	39	9	48	0.00016
Streptomyces sp. SCUT-3	2684469	S	38	22	60	0.00020
Streptomyces sp. XC 2026	2782004	S	37	111	148	0.00049
Streptomyces sp. BHT-5-2	2866715	S	35	29	64	0.00021
Streptomyces sp. ST1015	1848900	S	33	17	50	0.00016
Streptomyces sp. NHF165	2175864	S	32	11	43	0.00014
Streptomyces sp. NA02950	2742137	S	32	14	46	0.00015
Streptomyces sp. LRE541	2931983	S	31	20	51	0.00017
Streptomyces sp. BH-MK-02	2880933	S	31	15	46	0.00015
Streptomyces sp. WAC 01438	2203204	S	29	28	57	0.00019
Streptomyces sp. GMY02	1333528	S	28	10	38	0.00013
Streptomyces sp. GS7	2692234	S	27	20	47	0.00015
Streptomyces sp. C8S0	2585716	S	26	15	41	0.00013
Streptomyces sp. MBT27	1488356	S	26	15	41	0.00013
Streptomyces sp. P3	2135430	S	26	19	45	0.00015
Streptomyces sp. AMCC400023	2056258	S	26	37	63	0.00021
Streptomyces sp. CB01881	2078691	S	26	11	37	0.00012
Streptomyces sp. YIM 121038	2136401	S	26	20	46	0.00015
Streptomyces sp. HSG2	2797167	S	25	8	33	0.00011
Streptomyces sp. CdTB01	1725411	S	25	19	44	0.00014
Streptomyces sp. RerS4	2942449	S	25	21	46	0.00015
Streptomyces sp. 891-h	2720714	S	24	8	32	0.00011
Streptomyces sp. MRC013	2898276	S	23	18	41	0.00013
Streptomyces sp. SAT1	1849967	S	23	18	41	0.00013
Streptomyces sp. MST-110588	2833628	S	23	11	34	0.00011
Streptomyces sp. HUAS 13-4	2981134	S	23	15	38	0.00013
Streptomyces sp. NA04227	2742136	S	22	9	31	0.00010
Streptomyces sp. CA-210063	2801029	S	22	31	53	0.00017
Streptomyces sp. HUAS 14-6	2981135	S	21	21	42	0.00014
Streptomyces sp. RTd22	1841249	S	21	37	58	0.00019
Streptomyces sp. SirexAA-E	862751	S	21	17	38	0.00013
Streptomyces sp. HUAS 2-6	3004093	S	20	20	40	0.00013
Streptomyces sp. INR7	2607753	S	20	38	58	0.00019
Streptomyces sp. DSM 40750	2801030	S	20	26	46	0.00015
Streptomyces sp. WZ-12	3030210	S	19	13	32	0.00011
Streptomyces sp. W1SF4	2305220	S	19	16	35	0.00012
Streptomyces sp. S4.7	2705439	S	19	19	38	0.00013
Streptomyces sp. QHH-9511	2684468	S	19	12	31	0.00010
Streptomyces sp. NEAU-sy36	2751189	S	19	19	38	0.00013
Streptomyces sp. ST13-2-2	2879846	S	19	8	27	0.00009
Streptomyces sp. JB150	2714844	S	19	21	40	0.00013
Streptomyces sp. 135	2838850	S	19	20	39	0.00013
Streptomyces sp. M92	2944250	S	18	25	43	0.00014
Streptomyces sp. HL-66	2964669	S	18	13	31	0.00010
Streptomyces sp. 3214.6	1882757	S	17	14	31	0.00010
Streptomyces sp. FIT100	2837956	S	17	17	34	0.00011
Streptomyces sp. 769	1262452	S	17	44	61	0.00020
Streptomyces sp. S465	2979468	S	16	13	29	0.00010
Streptomyces sp. Go40/10	2825844	S	16	22	38	0.00013
Streptomyces sp. NBC_00162	2903629	S	16	14	30	0.00010
Streptomyces sp. GQFP	2907545	S	16	7	23	0.00008
Streptomyces sp. A2-16	2781734	S	16	16	32	0.00011
Streptomyces sp. SM18	1736046	S	15	11	26	0.00009
Streptomyces sp. YPW6	2840373	S	15	26	41	0.00013
Streptomyces sp. Tu 2975	2676871	S	15	12	27	0.00009
Streptomyces sp. WAC 01529	2203205	S	15	16	31	0.00010
Streptomyces sp. Z423-1	2730915	S	15	13	28	0.00009
Streptomyces sp. HUAS 15-9	2981136	S	15	10	25	0.00008
Streptomyces sp. CMB-StM0423	2059884	S	15	31	46	0.00015
Streptomyces sp. Caat 7-52	2949637	S	14	15	29	0.00010
Streptomyces sp. SYP-A7193	2662065	S	13	27	40	0.00013
Streptomyces sp. HM190	2695266	S	13	11	24	0.00008
Streptomyces sp. Go-475	2072505	S	13	19	32	0.00011
Streptomyces sp. AgN23	1188315	S	13	43	56	0.00018
Streptomyces sp. Je 1-369	2966192	S	12	15	27	0.00009
Streptomyces sp. S1D4-11	2721246	S	12	36	48	0.00016
Streptomyces sp. HF10	2692233	S	12	28	40	0.00013
Streptomyces sp. Rer75	2750011	S	12	24	36	0.00012
Streptomyces sp. KMM 9044	2744474	S	12	8	20	0.00007
Streptomyces sp. HP-A2021	2927875	S	12	23	35	0.00012
Streptomyces sp. Sge12	1972846	S	11	80	91	0.00030
Streptomyces sp. DSM 40868	2721173	S	10	10	20	0.00007
Streptomyces sp. MMBL 11-1	3026420	S	10	18	28	0.00009
Streptomyces sp. TN58	234612	S	10	15	25	0.00008
Streptomyces sp. Jing01	2726118	S	10	18	28	0.00009
Streptomyces sp. WAC 06738	2203210	S	10	49	59	0.00019
Streptomyces sp. SUK 48	2582831	S	10	21	31	0.00010
Streptomyces venezuelae	54571	S	126	118	244	0.00080
Streptomyces aurantiacus	47760	S	61	36	97	0.00032
Streptomyces cadmiisoli	2184053	S	17	8	25	0.00008
Streptomyces qaidamensis	1783515	S	16	20	36	0.00012
Streptomyces koyangensis	188770	S	15	43	58	0.00019
Streptomyces harbinensis	1176198	S	71	34	105	0.00035
Streptomyces griseus	1911	S	26	43	69	0.00023
Streptomyces microflavus	1919	S	17	148	165	0.00054
Streptomyces anulatus	1892	S	13	47	60	0.00020
Streptomyces globisporus	1908	S	10	66	76	0.00025
Streptomyces hygroscopicus	1912	S	29	95	124	0.00041
Streptomyces rapamycinicus	1226757	S	18	15	33	0.00011
Streptomyces marincola	2878388	S	60	18	78	0.00026
Streptomyces peucetius	1950	S	50	27	77	0.00025
Streptomyces xiamenensis	408015	S	44	124	168	0.00055
Streptomyces niveus	193462	S	42	25	67	0.00022
Streptomyces spectabilis	68270	S	38	31	69	0.00023
Streptomyces tsukubensis	83656	S	37	16	53	0.00017
Streptomyces griseorubiginosus	67304	S	36	30	66	0.00022
Streptomyces buecherae	2763006	S	35	14	49	0.00016
Streptomyces genisteinicus	2768068	S	34	19	53	0.00017
Streptomyces globosus	68209	S	34	21	55	0.00018
Streptomyces noursei	1971	S	33	57	90	0.00030
Streptomyces lydicus	47763	S	32	71	103	0.00034
Streptomyces bathyalis	2710756	S	30	7	37	0.00012
Streptomyces tubbatahanensis	2923272	S	30	9	39	0.00013
Streptomyces albus	1888	S	30	113	143	0.00047
Streptomyces durmitorensis	319947	S	29	13	42	0.00014
Streptomyces pristinaespiralis	38300	S	29	25	54	0.00018
Streptomyces lincolnensis	1915	S	29	21	50	0.00016
Streptomyces rimosus	1927	S	28	12	40	0.00013
Streptomyces luteoverticillatus	66425	S	28	15	43	0.00014
Streptomyces rutgersensis	53451	S	27	28	55	0.00018
Streptomyces xinghaiensis	1038928	S	27	12	39	0.00013
Streptomyces roseirectus	2768066	S	27	14	41	0.00013
Streptomyces chartreusis	1969	S	26	50	76	0.00025
Streptomyces seoulensis	73044	S	26	19	45	0.00015
Streptomyces atratus	1893	S	26	10	36	0.00012
Streptomyces capitiformicae	2014920	S	25	14	39	0.00013
Streptomyces griseochromogenes	68214	S	25	17	42	0.00014
Streptomyces armeniacus	83291	S	25	7	32	0.00011
Streptomyces lunaelactis	1535768	S	25	11	36	0.00012
Streptomyces antibioticus	1890	S	25	20	45	0.00015
Streptomyces phaeolivaceus	2653200	S	25	20	45	0.00015
Streptomyces tendae	1932	S	24	25	49	0.00016
Streptomyces lusitanus	68232	S	24	33	57	0.00019
Streptomyces katrae	68223	S	24	18	42	0.00014
Streptomyces nitrosporeus	28894	S	24	14	38	0.00013
Streptomyces collinus	42684	S	24	39	63	0.00021
Streptomyces pratensis	1169025	S	24	13	37	0.00012
Streptomyces paludis	2282738	S	24	9	33	0.00011
Streptomyces asoensis	249586	S	23	17	40	0.00013
Streptomyces formicae	1616117	S	23	23	46	0.00015
Streptomyces dengpaensis	2049881	S	23	13	36	0.00012
Streptomyces prasinus	67345	S	23	19	42	0.00014
Streptomyces vinaceus	1960	S	22	18	40	0.00013
Streptomyces ficellus	1977088	S	22	14	36	0.00012
Streptomyces alboflavus	67267	S	22	13	35	0.00012
Streptomyces subrutilus	36818	S	22	17	39	0.00013
Streptomyces tanashiensis	67367	S	22	21	43	0.00014
Streptomyces lavendulae	1914	S	21	16	37	0.00012
Streptomyces pactum	68249	S	21	22	43	0.00014
Streptomyces liangshanensis	2717324	S	21	9	30	0.00010
Streptomyces calvus	67282	S	21	22	43	0.00014
Streptomyces nigra	1827580	S	21	18	39	0.00013
Streptomyces inhibens	2293571	S	20	15	35	0.00012
Streptomyces liliifuscus	2797636	S	20	12	32	0.00011
Streptomyces clavuligerus	1901	S	20	6	26	0.00009
Streptomyces qinzhouensis	2599401	S	20	10	30	0.00010
Streptomyces griseocarneus	51201	S	20	11	31	0.00010
Streptomyces ferrugineus	1413221	S	19	16	35	0.00012
Streptomyces drozdowiczii	202862	S	19	12	31	0.00010
Streptomyces cyaneochromogenes	2496836	S	19	16	35	0.00012
Streptomyces gobiensis	2875706	S	19	5	24	0.00008
Streptomyces ambofaciens	1889	S	19	26	45	0.00015
Streptomyces actuosus	1885	S	19	18	37	0.00012
Streptomyces hawaiiensis	67305	S	19	25	44	0.00014
Streptomyces griseoviridis	45398	S	18	12	30	0.00010
Streptomyces xanthii	2768069	S	18	9	27	0.00009
Streptomyces tuirus	68278	S	18	24	42	0.00014
Streptomyces tirandamycinicus	2174846	S	18	13	31	0.00010
Streptomyces nodosus	40318	S	18	9	27	0.00009
Streptomyces olivoreticuli	68246	S	17	8	25	0.00008
Streptomyces thermocarboxydus	59299	S	17	27	44	0.00014
Streptomyces akebiae	2865673	S	17	18	35	0.00012
Streptomyces aureoverticillatus	66871	S	17	10	27	0.00009
Streptomyces glaucescens	1907	S	17	16	33	0.00011
Streptomyces viridosporus	67581	S	17	17	34	0.00011
Streptomyces coeruleorubidus	116188	S	17	25	42	0.00014
Streptomyces parvulus	146923	S	17	17	34	0.00011
Streptomyces pluripotens	1355015	S	16	7	23	0.00008
Streptomyces rectiverticillatus	173860	S	16	8	24	0.00008
Streptomyces fodineus	1904616	S	16	15	31	0.00010
Streptomyces roseochromogenus	285450	S	16	12	28	0.00009
Streptomyces exfoliatus	1905	S	15	11	26	0.00009
Streptomyces deccanensis	424188	S	15	20	35	0.00012
Streptomyces angustmyceticus	285578	S	15	15	30	0.00010
Streptomyces gilvosporeus	553510	S	15	9	24	0.00008
Streptomyces mobaraensis	35621	S	14	14	28	0.00009
Streptomyces broussonetiae	2686304	S	14	10	24	0.00008
Streptomyces dangxiongensis	1442032	S	14	12	26	0.00009
Streptomyces gardneri	66892	S	14	16	30	0.00010
Streptomyces vietnamensis	362257	S	14	13	27	0.00009
Streptomyces galilaeus	33899	S	14	15	29	0.00010
Streptomyces spongiicola	1690221	S	14	9	23	0.00008
Streptomyces finlayi	67296	S	13	5	18	0.00006
Streptomyces nojiriensis	66374	S	13	16	29	0.00010
Streptomyces xanthophaeus	67385	S	13	9	22	0.00007
Streptomyces aquilus	2548456	S	13	9	22	0.00007
Streptomyces chromofuscus	42881	S	13	11	24	0.00008
Streptomyces incarnatus	665007	S	12	12	24	0.00008
Streptomyces avermitilis	33903	S	12	7	19	0.00006
Streptomyces cinnabarinus	67287	S	12	13	25	0.00008
Streptomyces cyaneogriseus	68192	S	12	27	39	0.00013
Streptomyces cavourensis	67258	S	11	62	73	0.00024
Streptomyces tubercidicus	47759	S	10	11	21	0.00007
Streptomyces hundungensis	1077946	S	10	5	15	0.00005
Streptomyces murinus	33900	S	10	73	83	0.00027
Streptomyces nigrescens	1920	S	10	16	26	0.00009
Streptomyces cyanogenus	80860	S	10	12	22	0.00007
Kitasatospora sp. MMS16-BH015	2018025	S	49	20	69	0.00023
Kitasatospora sp. NA04385	2742135	S	27	23	50	0.00016
Kitasatospora sp. HUAS 3-15	3004092	S	23	18	41	0.00013
Kitasatospora sp. YST-16	2998080	S	22	20	42	0.00014
Kitasatospora setae	2066	S	27	21	48	0.00016
Kitasatospora aureofaciens	1894	S	23	21	44	0.00014
Streptacidiphilus sp. P02-A3a	2704468	S	40	14	54	0.00018
Streptacidiphilus sp. PB12-B1b	2705012	S	31	14	45	0.00015
Yinghuangia sp. ASG 101	2896848	S	52	11	63	0.00021
Actinacidiphila bryophytorum	1436133	S	35	15	50	0.00016
Peterkaempfera bronchialis	2126346	S	27	12	39	0.00013
Streptantibioticus cattleyicolor	29303	S	24	12	36	0.00012
Amycolatopsis sp. DSM 110486	2865832	S	54	15	69	0.00023
Amycolatopsis sp. Hca4	2742131	S	45	23	68	0.00022
Amycolatopsis sp. WQ 127309	2932773	S	45	18	63	0.00021
Amycolatopsis sp. CA-230715	2745196	S	42	10	52	0.00017
Amycolatopsis sp. FDAARGOS 1241	2778070	S	40	12	52	0.00017
Amycolatopsis sp. YIM 10	2653857	S	36	15	51	0.00017
Amycolatopsis sp. HUAS 11-8	2995223	S	33	10	43	0.00014
Amycolatopsis sp. FU40	2914159	S	28	13	41	0.00013
Amycolatopsis sp. BJA-103	1911175	S	24	13	37	0.00012
Amycolatopsis sp. AA4	1896961	S	17	9	26	0.00009
Amycolatopsis sp. EV170708-02-1	2919322	S	16	21	37	0.00012
Amycolatopsis sp. TNS106	2861750	S	15	15	30	0.00010
Amycolatopsis acidiphila	715473	S	54	17	71	0.00023
Amycolatopsis methanolica	1814	S	50	28	78	0.00026
Amycolatopsis albispora	1804986	S	44	31	75	0.00025
Amycolatopsis mediterranei	33910	S	39	19	58	0.00019
Amycolatopsis keratiniphila	129921	S	17	20	37	0.00012
Amycolatopsis japonica	208439	S	16	21	37	0.00012
Amycolatopsis pretoriensis	218821	S	37	18	55	0.00018
Amycolatopsis thermalba	944492	S	35	21	56	0.00018
Amycolatopsis aidingensis	2842453	S	27	5	32	0.00011
Amycolatopsis roodepoortensis	700274	S	20	21	41	0.00013
Amycolatopsis orientalis	31958	S	13	6	19	0.00006
Pseudonocardia sp. DSM 110487	2865833	S	119	25	144	0.00047
Pseudonocardia sp. HH130630-07	1690815	S	60	74	134	0.00044
Pseudonocardia sp. AL041005-10	445576	S	49	43	92	0.00030
Pseudonocardia sp. HH130629-09	1641402	S	34	46	80	0.00026
Pseudonocardia broussonetiae	2736640	S	103	54	157	0.00052
Pseudonocardia dioxanivorans	240495	S	82	31	113	0.00037
Pseudonocardia petroleophila	37331	S	79	75	154	0.00051
Pseudonocardia autotrophica	2074	S	74	28	102	0.00034
Pseudonocardia abyssalis	2792008	S	50	42	92	0.00030
Saccharopolyspora erythraea	1836	S	97	213	310	0.00102
Saccharopolyspora gregorii	33914	S	72	31	103	0.00034
Saccharopolyspora rosea	524884	S	63	24	87	0.00029
Saccharopolyspora gloriosae	455344	S	40	13	53	0.00017
Saccharopolyspora spinosa	60894	S	16	14	30	0.00010
Saccharopolyspora pogona	333966	S	10	17	27	0.00009
Saccharopolyspora sp. ASAGF58	2719023	S	10	19	29	0.00010
Saccharomonospora glauca	40990	S	110	42	152	0.00050
Saccharomonospora viridis	1852	S	48	9	57	0.00019
Saccharomonospora marina	632569	S	34	11	45	0.00015
Saccharomonospora azurea	40988	S	24	9	33	0.00011
Saccharomonospora xinjiangensis	75294	S	23	5	28	0.00009
Saccharomonospora cyanea	40989	S	21	9	30	0.00010
Saccharothrix syringae	103733	S	59	28	87	0.00029
Saccharothrix sp. 6-C	2781735	S	59	28	87	0.00029
Saccharothrix espanaensis	103731	S	51	21	72	0.00024
Kutzneria sp. CA-103260	2802641	S	50	19	69	0.00023
Kutzneria albida	43357	S	44	14	58	0.00019
Kutzneria chonburiensis	1483604	S	38	13	51	0.00017
Lentzea guizhouensis	1586287	S	56	22	78	0.00026
Lentzea sp. HUAS12	2951806	S	52	21	73	0.00024
Actinoalloteichus hoggarensis	1470176	S	28	36	64	0.00021
Actinoalloteichus hymeniacidonis	340345	S	16	7	23	0.00008
Actinosynnema pretiosum	42197	S	15	76	91	0.00030
Allokutzneria albata	211114	S	64	21	85	0.00028
Kibdelosporangium phytohabitans	860235	S	51	9	60	0.00020
Actinokineospora sp. UTMC 2448	2268449	S	47	21	68	0.00022
Alloactinosynnema sp. L-07	1653480	S	42	13	55	0.00018
Prauserella marina	530584	S	30	5	35	0.00012
Allosaccharopolyspora coralli	2665642	S	25	7	32	0.00011
Micromonospora sp. WMMC415	2675222	S	39	24	63	0.00021
Micromonospora sp. LH3U1	3018339	S	38	24	62	0.00020
Verrucosispora sp. NA02020	2742132	S	35	22	57	0.00019
Micromonospora sp. HM134	2583243	S	29	22	51	0.00017
Micromonospora sp. WMMA2032	2039870	S	18	20	38	0.00013
Micromonospora sp. B006	2201999	S	12	24	36	0.00012
Micromonospora krabiensis	307121	S	56	32	88	0.00029
Micromonospora echinofusca	47858	S	53	39	92	0.00030
Micromonospora sagamiensis	47875	S	45	30	75	0.00025
Micromonospora inositola	47865	S	44	36	80	0.00026
Micromonospora purpureochromogenes	47872	S	41	35	76	0.00025
Micromonospora coriariae	285665	S	40	26	66	0.00022
Micromonospora auratinigra	261654	S	38	33	71	0.00023
Micromonospora narathiwatensis	299146	S	37	29	66	0.00022
Micromonospora carbonacea	47853	S	37	26	63	0.00021
Micromonospora echinaurantiaca	47857	S	37	29	66	0.00022
Micromonospora maris	1003110	S	37	17	54	0.00018
Micromonospora zamorensis	709883	S	36	25	61	0.00020
Micromonospora coxensis	356852	S	34	31	65	0.00021
Micromonospora viridifaciens	1881	S	31	22	53	0.00017
Micromonospora echinospora	1877	S	30	18	48	0.00016
Micromonospora chokoriensis	356851	S	30	18	48	0.00016
Micromonospora siamensis	299152	S	27	20	47	0.00015
Micromonospora terminaliae	1914461	S	26	22	48	0.00016
Micromonospora ferruginea	2749844	S	23	23	46	0.00015
Micromonospora endophytica	515350	S	17	7	24	0.00008
Micromonospora rifamycinica	291594	S	17	13	30	0.00010
Micromonospora craniellae	2294034	S	15	9	24	0.00008
Micromonospora chalcea	1874	S	13	29	42	0.00014
Actinoplanes sp. L3-i22	2836373	S	81	64	145	0.00048
Actinoplanes sp. N902-109	649831	S	58	24	82	0.00027
Actinoplanes sp. OR16	946334	S	50	28	78	0.00026
Actinoplanes friuliensis	196914	S	77	20	97	0.00032
Actinoplanes ianthinogenes	122358	S	58	29	87	0.00029
Actinoplanes missouriensis	1866	S	52	22	74	0.00024
Actinoplanes teichomyceticus	1867	S	51	28	79	0.00026
Actinoplanes derwentensis	113562	S	47	10	57	0.00019
Dactylosporangium aurantiacum	35754	S	81	22	103	0.00034
Dactylosporangium fulvum	53359	S	39	16	55	0.00018
Dactylosporangium roseum	47989	S	29	14	43	0.00014
Dactylosporangium matsuzakiense	53360	S	29	74	103	0.00034
Dactylosporangium vinaceum	53362	S	18	38	56	0.00018
Phytohabitans suffuscus	624315	S	80	30	110	0.00036
Phytohabitans flavus	1076124	S	51	15	66	0.00022
Plantactinospora sp. KBS50	2024580	S	43	18	61	0.00020
Plantactinospora sp. BB1	2071627	S	13	61	74	0.00024
Actinocatenispora thailandica	227318	S	43	29	72	0.00024
Actinocatenispora sera	390989	S	42	23	65	0.00021
Catellatospora sp. IY07-71	2728827	S	86	28	114	0.00038
Couchioplanes caeruleus	56438	S	63	27	90	0.00030
Polymorphospora rubra	338584	S	36	14	50	0.00016
Salinispora tropica	168695	S	27	8	35	0.00012
Natronosporangium hydrolyticum	2811111	S	26	3	29	0.00010
Blastococcus saxobsidens	138336	S	460	202	662	0.00218
Blastococcus sp. PRF04-17	2933797	S	374	174	548	0.00180
Modestobacter marinus	477641	S	377	185	562	0.00185
Modestobacter sp. L9-4	2851567	S	308	167	475	0.00156
Geodermatophilus obscurus	1861	S	357	171	528	0.00174
Nocardiopsis alba	53437	S	251	68	319	0.00105
Nocardiopsis sp. HDS12	2831968	S	21	93	114	0.00038
Nocardiopsis exhalans	163604	S	67	17	84	0.00028
Nocardiopsis gilva	280236	S	27	7	34	0.00011
Nocardiopsis dassonvillei	2014	S	21	25	46	0.00015
Thermobifida fusca	2021	S	68	13	81	0.00027
Thermobifida alba	53522	S	41	16	57	0.00019
Thermobifida halotolerans	483545	S	34	11	45	0.00015
Streptomonospora nanhaiensis	1323731	S	40	17	57	0.00019
Streptomonospora litoralis	2498135	S	33	8	41	0.00013
Spiractinospora alimapuensis	2820884	S	29	3	32	0.00011
Actinomadura sp. WMMA1423	2591108	S	64	28	92	0.00030
Actinomadura sp. WMMB 499	1219491	S	60	21	81	0.00027
Actinomadura sp. NAK00032	2742128	S	57	29	86	0.00028
Actinomadura madurae	1993	S	73	34	107	0.00035
Actinomadura verrucosospora	46165	S	62	29	91	0.00030
Actinomadura graeca	2750812	S	52	18	70	0.00023
Thermomonospora curvata	2020	S	50	21	71	0.00023
Thermomonospora amylolytica	1411117	S	49	26	75	0.00025
Nonomuraea coxensis	404386	S	64	29	93	0.00031
Nonomuraea sp. ATCC 55076	1909395	S	56	30	86	0.00028
Nonomuraea phyllanthi	2219224	S	53	18	71	0.00023
Nonomuraea gerenzanensis	93944	S	50	28	78	0.00026
Streptosporangium sp. 'caverna'	2202249	S	105	28	133	0.00044
Streptosporangium roseum	2001	S	64	21	85	0.00028
Thermobispora bispora	2006	S	49	14	63	0.00021
Actinomyces sp. MAS-1	2755559	S	18	10	28	0.00009
Actinomyces sp. oral taxon 414	712122	S	17	15	32	0.00011
Actinomyces radicidentis	111015	S	19	8	27	0.00009
Actinomyces howellii	52771	S	16	3	19	0.00006
Actinomyces respiraculi	2744574	S	16	10	26	0.00009
Actinomyces viscosus	1656	S	15	10	25	0.00008
Actinomyces faecalis	2722820	S	15	3	18	0.00006
Actinomyces oris	544580	S	12	43	55	0.00018
Actinomyces naeslundii	1655	S	12	8	20	0.00007
Actinomyces wuliandei	2057743	S	11	5	16	0.00005
Actinomyces lilanjuaniae	2321394	S	11	4	15	0.00005
Schaalia sp. 19OD2882	2794089	S	13	2	15	0.00005
Schaalia odontolytica	1660	S	13	5	18	0.00006
Flaviflexus salsibiostraticola	1282737	S	18	5	23	0.00008
Flaviflexus equikiangi	2758573	S	15	3	18	0.00006
Nanchangia anserum	2692125	S	11	1	12	0.00004
Pauljensenia hongkongensis	178339	S	10	5	15	0.00005
Frankia inefficax	298654	S	64	9	73	0.00024
Frankia sp. ArI3	1858	S	27	16	43	0.00014
Frankia sp. QA3	710111	S	23	9	32	0.00011
Candidatus Frankia datiscae	2716812	S	37	9	46	0.00015
Frankia alni	1859	S	33	21	54	0.00018
Frankia casuarinae	106370	S	29	3	32	0.00011
Nakamurella multipartita	53461	S	96	24	120	0.00040
Nakamurella panacisegetis	1090615	S	36	10	46	0.00015
Nakamurella sp. PAMC28650	2762325	S	33	7	40	0.00013
Nakamurella antarctica	1902245	S	14	1	15	0.00005
Bifidobacterium pseudolongum	1694	S	27	8	35	0.00012
Bifidobacterium choerinum	35760	S	15	4	19	0.00006
Bifidobacterium longum	216816	S	13	39	52	0.00017
Bifidobacterium angulatum	1683	S	10	2	12	0.00004
Jiangella alkaliphila	419479	S	68	32	100	0.00033
Jiangella sp. DSM 45060	1798224	S	56	27	83	0.00027
Jatrophihabitans sp. SB3-54	2944128	S	72	18	90	0.00030
Jatrophihabitans sp. GAS493	1907575	S	23	3	26	0.00009
Jatrophihabitans telluris	2038343	S	34	5	39	0.00013
Kineococcus radiotolerans	131568	S	111	33	144	0.00047
Catenulispora acidiphila	304895	S	60	10	70	0.00023
Epidermidibacterium keratini	1891644	S	59	22	81	0.00027
Stackebrandtia nassauensis	283811	S	45	5	50	0.00016
Actinopolyspora erythraea	414996	S	20	3	23	0.00008
Acidothermus cellulolyticus	28049	S	16	1	17	0.00006
Iamia sp. SCSIO 61187	2722752	S	1434	303	1737	0.00572
Iamia majanohamensis	467976	S	210	47	257	0.00085
Aquihabitans sp. G128	2849779	S	264	61	325	0.00107
Aquihabitans sp. Kera 3	2884263	S	138	24	162	0.00053
Actinomarinicola tropica	2789776	S	200	43	243	0.00080
Ilumatobacter coccineus	467094	S	76	5	81	0.00027
Acidimicrobium ferrooxidans	53635	S	11	0	11	0.00004
Conexibacter sp. SYSU D00693	2812560	S	134	51	185	0.00061
Conexibacter sp. S30A1	2937800	S	51	6	57	0.00019
Conexibacter sp. DBS9H8	2937801	S	49	6	55	0.00018
Conexibacter woesei	191495	S	152	41	193	0.00064
Capillimicrobium parvum	2884022	S	167	48	215	0.00071
Paraconexibacter antarcticus	2949664	S	119	33	152	0.00050
Miltoncostaea oceani	2843216	S	321	40	361	0.00119
Miltoncostaea marina	2843215	S	58	13	71	0.00023
Thermoleophilum album	29539	S	52	5	57	0.00019
Baekduia sp. 0141_2	2997333	S	146	37	183	0.00060
Baekduia soli	496014	S	122	32	154	0.00051
Rubrobacter xylanophilus	49319	S	52	7	59	0.00019
Rubrobacter tropicus	2653851	S	48	5	53	0.00017
Rubrobacter marinus	2653852	S	40	6	46	0.00015
Euzebya pacifica	1608957	S	45	3	48	0.00016
Egicoccus halophilus	1670830	S	42	6	48	0.00016
Egibacter rhizosphaerae	1670831	S	31	2	33	0.00011
Olsenella timonensis	1805478	S	17	5	22	0.00007
Bacillus pumilus	1408	S	30	69	99	0.00033
Peribacillus frigoritolerans	450367	S	53	9	62	0.00020
Peribacillus simplex	1478	S	13	2	15	0.00005
Priestia megaterium	1404	S	61	50	111	0.00037
Alkalihalobacillus clausii	79880	S	12	2	14	0.00005
Pradoshia sp. D12	2651284	S	10	1	11	0.00004
Exiguobacterium sp. Helios	2735868	S	85	23	108	0.00036
Exiguobacterium sibiricum	332410	S	84	22	106	0.00035
Exiguobacterium mexicanum	340146	S	30	10	40	0.00013
Exiguobacterium aurantiacum	33987	S	25	9	34	0.00011
Exiguobacterium acetylicum	41170	S	23	24	47	0.00015
Hydrogenibacillus sp. N12	2866627	S	10	1	11	0.00004
Paenibacillus sp. B01	2660554	S	14	45	59	0.00019
Thermobacillus composti	377615	S	12	3	15	0.00005
Saccharibacillus brassicae	2583377	S	12	2	14	0.00005
Staphylococcus succinus	61015	S	85	15	100	0.00033
Staphylococcus equorum	246432	S	12	47	59	0.00019
Staphylococcus xylosus	1288	S	10	4	14	0.00005
Mammaliicoccus lentus	42858	S	18	7	25	0.00008
Mammaliicoccus sciuri	1296	S	16	5	21	0.00007
Jeotgalicoccus sp. WY2	2708346	S	13	1	14	0.00005
Planococcus glaciei	459472	S	38	16	54	0.00018
Kurthia zopfii	1650	S	11	3	14	0.00005
Thermoactinomyces vulgaris	2026	S	43	6	49	0.00016
Alicyclobacillus acidocaldarius	405212	S	12	1	13	0.00004
Lactobacillus amylovorus	1604	S	28	11	39	0.00013
Lactobacillus crispatus	47770	S	23	8	31	0.00010
Lactobacillus johnsonii	33959	S	13	4	17	0.00006
Lactobacillus helveticus	1587	S	12	5	17	0.00006
Leuconostoc mesenteroides	1245	S	18	16	34	0.00011
Leuconostoc pseudomesenteroides	33968	S	10	11	21	0.00007
Weissella cibaria	137591	S	14	5	19	0.00006
Limosilactobacillus reuteri	1598	S	10	4	14	0.00005
Lactiplantibacillus plantarum	1590	S	17	35	52	0.00017
Loigolactobacillus coryniformis	1610	S	16	10	26	0.00009
Lactococcus lactis	1358	S	122	95	217	0.00071
Lactococcus cremoris	1359	S	18	8	26	0.00009
Lactococcus raffinolactis	1366	S	18	4	22	0.00007
Streptococcus alactolyticus	29389	S	11	18	29	0.00010
Enterococcus casseliflavus	37734	S	11	15	26	0.00009
Vagococcus carniphilus	218144	S	12	2	14	0.00005
Vagococcus fluvialis	2738	S	10	2	12	0.00004
Aerococcus urinaeequi	51665	S	17	5	22	0.00007
Clostridium perfringens	1502	S	22	25	47	0.00015
Clostridium botulinum	1491	S	16	6	22	0.00007
Blautia hansenii	1322	S	11	22	33	0.00011
Herbinix luporum	1679721	S	16	9	25	0.00008
[Ruminococcus] gnavus	33038	S	12	11	23	0.00008
Faecalibacterium prausnitzii	853	S	13	38	51	0.00017
Symbiobacterium thermophilum	2734	S	24	2	26	0.00009
Caldinitratiruptor microaerophilus	671077	S	15	1	16	0.00005
Thermaerobacter sp. FW80	2546351	S	10	6	16	0.00005
Megamonas funiformis	437897	S	20	2	22	0.00007
Limnochorda pilosa	1555112	S	16	0	16	0.00005
Deinococcus ficus	317577	S	983	101	1084	0.00357
Deinococcus sp. NW-56	2080419	S	150	29	179	0.00059
Deinococcus sp. QL22	2939437	S	64	4	68	0.00022
Deinococcus sp. AJ005	2652443	S	56	6	62	0.00020
Deinococcus sp. TS-293	2737050	S	47	5	52	0.00017
Deinococcus radiopugnans	57497	S	97	15	112	0.00037
Deinococcus actinosclerus	1768108	S	86	46	132	0.00043
Deinococcus aquaticus	328692	S	68	11	79	0.00026
Deinococcus soli (ex Cha et al. 2016)	1309411	S	59	50	109	0.00036
Deinococcus aetherius	200252	S	55	5	60	0.00020
Deinococcus wulumuqiensis	980427	S	48	13	61	0.00020
Deinococcus metallilatus	1211322	S	48	7	55	0.00018
Deinococcus gobiensis	502394	S	38	4	42	0.00014
Deinococcus irradiatisoli	2202254	S	20	2	22	0.00007
Deinococcus psychrotolerans	2489213	S	20	0	20	0.00007
Deinococcus puniceus	1182568	S	19	2	21	0.00007
Deinococcus maricopensis	309887	S	18	1	19	0.00006
Deinococcus deserti	310783	S	18	1	19	0.00006
Deinococcus radiodurans	1299	S	17	4	21	0.00007
Deinococcus rubellus	1889240	S	14	1	15	0.00005
Deinococcus peraridilitoris	432329	S	13	0	13	0.00004
Deinococcus proteolyticus	55148	S	12	2	14	0.00005
Deinococcus geothermalis	68909	S	10	1	11	0.00004
Marinithermus hydrothermalis	186192	S	10	1	11	0.00004
Truepera radiovictrix	332249	S	14	0	14	0.00005
Microcoleus vaginatus	119532	S	292	38	330	0.00109
Oscillatoria nigro-viridis	482564	S	170	30	200	0.00066
Oscillatoria acuminata	118323	S	77	3	80	0.00026
Allocoleopsis franciscana	2886352	S	37	3	40	0.00013
Crinalium epipsammum	241425	S	36	4	40	0.00013
Leptolyngbya sp. 7M	2812896	S	30	1	31	0.00010
Tepidiforma bonchosmolovskayae	2601677	S	14	5	19	0.00006
Roseiflexus sp. RS-1	357808	S	10	2	12	0.00004
Candidatus Promineofilum breve	1806508	S	17	1	18	0.00006
Sphaerobacter thermophilus	2057	S	30	1	31	0.00010
Thermomicrobium roseum	500	S	10	0	10	0.00003
Sphingomonas sp. PAMC26645	2565555	S	415	199	614	0.00202
Sphingomonas sp. KRR8	2942996	S	247	55	302	0.00099
Sphingomonas sp. HMP9	1517554	S	215	126	341	0.00112
Sphingomonas sp. HDW15A	2714942	S	201	27	228	0.00075
Sphingomonas sp. AAP5	1523415	S	96	43	139	0.00046
Sphingomonas sp. NBWT7	2596913	S	92	52	144	0.00047
Sphingomonas sp. CV7422	3018036	S	86	67	153	0.00050
Sphingomonas sp. RMG20	2949093	S	79	29	108	0.00036
Sphingomonas sp. CL5.1	2653203	S	79	48	127	0.00042
Sphingomonas sp. S6-11	2991075	S	76	26	102	0.00034
Sphingomonas sp. QA11	2950605	S	76	17	93	0.00031
Sphingomonas sp. PAMB00755	3012344	S	72	20	92	0.00030
Sphingomonas sp. MM-1	745310	S	70	182	252	0.00083
Sphingomonas sp. SUN039	2937787	S	69	10	79	0.00026
Sphingomonas sp. R1	399176	S	68	30	98	0.00032
Sphingomonas sp. 7/4-4	3018446	S	67	30	97	0.00032
Sphingomonas sp. AP4-R1	2735134	S	67	14	81	0.00027
Sphingomonas sp. SUN019	2937788	S	66	17	83	0.00027
Sphingomonas sp. ZFBP2030	2972485	S	65	17	82	0.00027
Sphingomonas sp. HMP6	1517551	S	64	18	82	0.00027
Sphingomonas sp. KC8	1030157	S	64	15	79	0.00026
Sphingomonas sp. S2-65	2903960	S	62	20	82	0.00027
Sphingomonas sp. FARSPH	2219696	S	61	64	125	0.00041
Sphingomonas sp. J315	2898433	S	61	33	94	0.00031
Sphingomonas sp. BT-65	2989821	S	59	27	86	0.00028
Sphingomonas sp. So64.6b	2997354	S	57	17	74	0.00024
Sphingomonas sp. NIBR 02145	3014784	S	54	19	73	0.00024
Sphingomonas sp. LM7	1938607	S	49	21	70	0.00023
Sphingomonas sp. S1-29	2991074	S	45	72	117	0.00039
Sphingomonas sp. LK11	1390395	S	39	54	93	0.00031
Sphingomonas sp. NIC1	1961362	S	31	128	159	0.00052
Sphingomonas sp. H160509	2955313	S	19	2	21	0.00007
Sphingomonas sp. IC081	304378	S	13	110	123	0.00040
Sphingomonas glaciei	2938948	S	3096	696	3792	0.01248
Sphingomonas aerolata	185951	S	796	365	1161	0.00382
Sphingomonas ginsengisoli An et al. 2013	363835	S	425	153	578	0.00190
Sphingomonas rhizophila	2071607	S	362	120	482	0.00159
Sphingomonas lutea	1045317	S	346	76	422	0.00139
Sphingomonas sinipercae	2714944	S	297	69	366	0.00121
Sphingomonas sediminicola	386874	S	234	35	269	0.00089
Sphingomonas sabuli	2764186	S	221	50	271	0.00089
Sphingomonas daechungensis	1176646	S	216	34	250	0.00082
Sphingomonas piscis	2714943	S	215	33	248	0.00082
Sphingomonas xanthus	2594473	S	189	50	239	0.00079
Sphingomonas taxi	1549858	S	112	75	187	0.00062
Sphingomonas aliaeris	2759526	S	108	26	134	0.00044
Sphingomonas cannabina	2899123	S	97	51	148	0.00049
Sphingomonas sanxanigenens	397260	S	96	83	179	0.00059
Sphingomonas profundi	2681549	S	90	28	118	0.00039
Sphingomonas radiodurans	2890321	S	83	21	104	0.00034
Sphingomonas nostoxanthinifaciens	2872652	S	78	21	99	0.00033
Sphingomonas naphthae	1813468	S	73	54	127	0.00042
Sphingomonas changnyeongensis	2698679	S	73	24	97	0.00032
Sphingomonas panacis	1560345	S	72	19	91	0.00030
Sphingomonas hengshuiensis	1609977	S	70	20	90	0.00030
Sphingomonas insulae	424800	S	69	34	103	0.00034
Sphingomonas psychrotolerans	1327635	S	63	20	83	0.00027
Sphingomonas hankookensis	563996	S	62	50	112	0.00037
Sphingomonas panacisoli	1813879	S	60	16	76	0.00025
Sphingomonas suaedae	2599297	S	55	18	73	0.00024
Sphingomonas alpina	653931	S	52	16	68	0.00022
Sphingomonas morindae	1541170	S	51	16	67	0.00022
Sphingomonas koreensis	93064	S	49	75	124	0.00041
Sphingomonas bisphenolicum	296544	S	45	77	122	0.00040
Sphingomonas lacunae	2698828	S	38	5	43	0.00014
Sphingomonas qomolangmaensis	2918765	S	38	59	97	0.00032
Sphingomonas paucimobilis	13689	S	35	35	70	0.00023
Sphingomonas melonis	152682	S	33	155	188	0.00062
Sphingomonas sanguinis	33051	S	30	33	63	0.00021
Sphingomonas paeninsulae	2319844	S	29	1	30	0.00010
Novosphingobium sp. Gsoil 351	2675225	S	167	24	191	0.00063
Novosphingobium sp. EMRT-2	2571749	S	112	94	206	0.00068
Novosphingobium sp. THN1	1016987	S	90	57	147	0.00048
Novosphingobium sp. P6W	1609758	S	82	17	99	0.00033
Novosphingobium sp. Sx8-5	2896849	S	81	25	106	0.00035
Novosphingobium sp. ES2-1	2780074	S	72	67	139	0.00046
Novosphingobium sp. 9	2025349	S	53	16	69	0.00023
Novosphingobium sp. KACC 22771	3025670	S	45	16	61	0.00020
Novosphingobium sp. PP1Y	702113	S	34	63	97	0.00032
Novosphingobium sp. KA1	164608	S	19	134	153	0.00050
Novosphingobium ginsenosidimutans	1176536	S	117	22	139	0.00046
Novosphingobium aromaticivorans	48935	S	105	87	192	0.00063
Novosphingobium resinovorum	158500	S	98	78	176	0.00058
Novosphingobium decolorationis	2698673	S	47	37	84	0.00028
Novosphingobium humi	2282397	S	39	13	52	0.00017
Novosphingobium pentaromativorans	205844	S	34	99	133	0.00044
Novosphingobium terrae	2726189	S	10	0	10	0.00003
Sphingobium sp. JS3065	2970925	S	69	89	158	0.00052
Sphingobium sp. KCTC 72723	2733867	S	57	15	72	0.00024
Sphingobium sp. SYK-6	627192	S	49	27	76	0.00025
Sphingobium sp. RAC03	1843368	S	49	18	67	0.00022
Sphingobium sp. CAP-1	2676077	S	34	43	77	0.00025
Sphingobium sp. EP60837	1855519	S	34	16	50	0.00016
Sphingobium sp. TKS	1315974	S	33	59	92	0.00030
Sphingobium sp. SCG-1	2072936	S	32	3	35	0.00012
Sphingobium sp. YG1	2082188	S	32	28	60	0.00020
Sphingobium sp. AntQ-1	2930091	S	31	26	57	0.00019
Sphingobium sp. Cam5-1	2789327	S	27	22	49	0.00016
Sphingobium sp. RSMS	520734	S	14	144	158	0.00052
Sphingobium sp. CFD-1	2878545	S	12	78	90	0.00030
Sphingobium sp. MI1205	407020	S	10	23	33	0.00011
Sphingobium xenophagum	121428	S	71	93	164	0.00054
Sphingobium yanoikuyae	13690	S	44	115	159	0.00052
Sphingobium cloacae	120107	S	42	109	151	0.00050
Sphingobium phenoxybenzoativorans	1592790	S	41	21	62	0.00020
Sphingobium amiense	135719	S	40	88	128	0.00042
Sphingobium indicum	332055	S	34	45	79	0.00026
Sphingobium herbicidovorans	76947	S	25	30	55	0.00018
Sphingobium chlorophenolicum	46429	S	19	16	35	0.00012
Sphingobium baderi	1332080	S	14	80	94	0.00031
Sphingopyxis sp. 113P3	292913	S	62	40	102	0.00034
Sphingopyxis sp. YF1	2482763	S	53	28	81	0.00027
Sphingopyxis sp. FD7	1914525	S	50	35	85	0.00028
Sphingopyxis sp. DBS4	2968500	S	43	52	95	0.00031
Sphingopyxis sp. OPL5	2486273	S	38	14	52	0.00017
Sphingopyxis sp. USTB-05	2830667	S	35	17	52	0.00017
Sphingopyxis sp. QXT-31	1357916	S	32	15	47	0.00015
Sphingopyxis sp. BSN-002	2911495	S	31	10	41	0.00013
Sphingopyxis sp. PET50	2976533	S	29	12	41	0.00013
Sphingopyxis sp. EG6	1874061	S	27	19	46	0.00015
Sphingopyxis sp. PAMC25046	2565556	S	24	16	40	0.00013
Sphingopyxis macrogoltabida	33050	S	85	65	150	0.00049
Sphingopyxis lindanitolerans	2054227	S	46	52	98	0.00032
Sphingopyxis fribergensis	1515612	S	39	25	64	0.00021
Sphingopyxis granuli	267128	S	38	155	193	0.00064
Sphingopyxis alaskensis	117207	S	33	15	48	0.00016
Sphingopyxis terrae	33052	S	15	75	90	0.00030
Rhizorhabdus wittichii	160791	S	69	74	143	0.00047
Rhizorhabdus phycosphaerae	2711156	S	63	13	76	0.00025
Rhizorhabdus dicambivorans	1850238	S	61	108	169	0.00056
Sphingomicrobium aestuariivivum	1582356	S	94	23	117	0.00039
Sphingomicrobium flavum	1229164	S	89	14	103	0.00034
Sphingosinithalassobacter sp. CS137	2762748	S	119	40	159	0.00052
Sphingosinithalassobacter tenebrarum	2711215	S	43	17	60	0.00020
Sphingorhabdus sp. SMR4y	2584094	S	24	6	30	0.00010
Sphingorhabdus sp. M41	1806885	S	23	4	27	0.00009
Sphingorhabdus sp. YGSMI21	2077182	S	21	5	26	0.00009
Sphingorhabdus lacus	392610	S	41	2	43	0.00014
Allosphingosinicella indica	941907	S	99	24	123	0.00040
Blastomonas sp. RAC04	1842535	S	35	41	76	0.00025
Blastomonas fulva	1550728	S	14	22	36	0.00012
Parasphingopyxis algicola	2026624	S	47	5	52	0.00017
Parasphingopyxis sp. CP4	2724527	S	16	0	16	0.00005
Citromicrobium sp. JL477	1634516	S	54	29	83	0.00027
Hankyongella ginsenosidimutans	1763828	S	29	8	37	0.00012
Novosphingopyxis iocasae	2762729	S	26	15	41	0.00013
Aquisediminimonas profunda	1550733	S	25	1	26	0.00009
Tardibacter chloracetimidivorans	1921510	S	25	42	67	0.00022
Parasphingorhabdus cellanae	2806553	S	10	0	10	0.00003
Altererythrobacter sp. TH136	2067415	S	8504	2158	10662	0.03510
Altererythrobacter sp. B11	2060312	S	74	37	111	0.00037
Altererythrobacter sp. BO-6	2604537	S	59	12	71	0.00023
Altererythrobacter sp. ZODW24	2185142	S	26	1	27	0.00009
Altererythrobacter epoxidivorans	361183	S	38	12	50	0.00016
Altererythrobacter ishigakiensis	476157	S	12	0	12	0.00004
Erythrobacter sp. SDW2	2907154	S	84	31	115	0.00038
Erythrobacter sp. HL-111	1798193	S	72	27	99	0.00033
Erythrobacter sp. HKB08	2502843	S	63	22	85	0.00028
Erythrobacter sp. 3-20A1M	2653850	S	62	50	112	0.00037
Erythrobacter sp. JK5	2829500	S	60	25	85	0.00028
Erythrobacter sp. A30-3	2785907	S	49	39	88	0.00029
Erythrobacter sp. BLCC-B19	3025315	S	45	26	71	0.00023
Erythrobacter sp. THAF29	2587851	S	43	13	56	0.00018
Erythrobacter sp. KY5	2011159	S	37	5	42	0.00014
Erythrobacter litoralis	39960	S	109	54	163	0.00054
Erythrobacter neustonensis	1112	S	69	30	99	0.00033
Erythrobacter mangrovi	2739433	S	59	26	85	0.00028
Erythrobacter aurantius	2909249	S	46	8	54	0.00018
Erythrobacter aureus	2182384	S	42	9	51	0.00017
Porphyrobacter sp. CACIAM 03H1	2003315	S	72	42	114	0.00038
Porphyrobacter sp. ULC335	2854260	S	50	18	68	0.00022
Porphyrobacter sp. HT-58-2	2023229	S	49	22	71	0.00023
Porphyrobacter sp. LM 6	1896196	S	36	22	58	0.00019
Tsuneonella amylolytica	2338327	S	387	143	530	0.00174
Tsuneonella dongtanensis	692370	S	235	65	300	0.00099
Tsuneonella mangrovi	1982042	S	96	22	118	0.00039
Tsuneonella flava	2055955	S	52	20	72	0.00024
Qipengyuania sp. PHS-Z21	2909673	S	101	63	164	0.00054
Qipengyuania sp. SS22	2979461	S	53	17	70	0.00023
Qipengyuania flava	192812	S	134	82	216	0.00071
Qipengyuania sediminis	1532023	S	124	24	148	0.00049
Qipengyuania gelatinilytica	2867231	S	47	14	61	0.00020
Qipengyuania aurantiaca	2867233	S	47	20	67	0.00022
Qipengyuania soli	2782568	S	44	11	55	0.00018
Qipengyuania seohaensis	266951	S	40	11	51	0.00017
Qipengyuania aquimaris	255984	S	28	42	70	0.00023
Qipengyuania psychrotolerans	2867238	S	26	3	29	0.00010
Qipengyuania xiapuensis	2867236	S	20	31	51	0.00017
Croceicoccus marinus	450378	S	111	71	182	0.00060
Croceicoccus sp. YJ47	2798724	S	48	24	72	0.00024
Croceicoccus sp. Ery5	1703340	S	27	32	59	0.00019
Croceicoccus sp. Ery15	1703338	S	16	27	43	0.00014
Croceicoccus naphthovorans	1348774	S	65	98	163	0.00054
Aurantiacibacter sp. MUD11	3003265	S	81	26	107	0.00035
Aurantiacibacter sp. MUD61	3009083	S	46	7	53	0.00017
Aurantiacibacter atlanticus	1648404	S	31	14	45	0.00015
Aurantiacibacter gangjinensis	502682	S	28	5	33	0.00011
Pelagerythrobacter marensis	543877	S	69	15	84	0.00028
Croceibacterium atlanticum	1267766	S	45	18	63	0.00021
Paraurantiacibacter namhicola	645517	S	38	8	46	0.00015
Sphingosinicella sp. BN140058	1892855	S	103	14	117	0.00039
Sphingosinicella microcystinivorans	335406	S	74	45	119	0.00039
Sphingosinicella flava	2771430	S	58	14	72	0.00024
Polymorphobacter sp. PAMC 29334	2862331	S	28	23	51	0.00017
Polymorphobacter megasporae	2835787	S	13	11	24	0.00008
Sandaracinobacteroides saxicola	2759707	S	32	5	37	0.00012
Paracoccus everestensis	2903900	S	11521	2148	13669	0.04500
Paracoccus sp. AK26	2589076	S	1324	316	1640	0.00540
Paracoccus sp. MC1862	2760307	S	697	155	852	0.00281
Paracoccus sp. Arc7-R13	2500532	S	442	621	1063	0.00350
Paracoccus sp. MA	2895796	S	94	63	157	0.00052
Paracoccus sp. SCSIO 75817	3017781	S	47	43	90	0.00030
Paracoccus sp. SCSIO 76264	3017783	S	43	21	64	0.00021
Paracoccus sp. SCSIO 80058	3017784	S	42	16	58	0.00019
Paracoccus sp. SCSIO 75233	3017782	S	41	35	76	0.00025
Paracoccus sp. TK19116	2922394	S	35	4	39	0.00013
Paracoccus sp. (in: a-proteobacteria)	267	S	20	1	21	0.00007
Paracoccus marcusii	59779	S	1071	980	2051	0.00675
Paracoccus yeei	147645	S	542	635	1177	0.00388
Paracoccus sanguinis	1545044	S	332	117	449	0.00148
Paracoccus liaowanqingii	2560053	S	325	50	375	0.00123
Paracoccus contaminans	1945662	S	286	86	372	0.00122
Paracoccus stylophorae	659350	S	225	93	318	0.00105
Paracoccus aestuarii	453842	S	203	52	255	0.00084
Paracoccus zhejiangensis	1077935	S	156	47	203	0.00067
Paracoccus alcaliphilus	34002	S	150	68	218	0.00072
Paracoccus jeotgali	2065379	S	137	35	172	0.00057
Paracoccus denitrificans	266	S	121	60	181	0.00060
Paracoccus suum	2259340	S	117	29	146	0.00048
Paracoccus aminovorans	34004	S	114	41	155	0.00051
Paracoccus fistulariae	658446	S	109	33	142	0.00047
Paracoccus pantotrophus	82367	S	109	68	177	0.00058
Paracoccus methylovorus	2812658	S	74	17	91	0.00030
Paracoccus saliphilus	405559	S	70	7	77	0.00025
Paracoccus kondratievae	135740	S	65	18	83	0.00027
Paracoccus tegillarcae	1529068	S	62	7	69	0.00023
Paracoccus aminophilus	34003	S	53	7	60	0.00020
Paracoccus seriniphilus	184748	S	46	5	51	0.00017
Paracoccus mutanolyticus	1499308	S	24	68	92	0.00030
Cereibacter sphaeroides	1063	S	120	51	171	0.00056
Cereibacter azotoformans	43057	S	31	96	127	0.00042
Rhodobacter sp. CZR27	2033869	S	65	21	86	0.00028
Rhodobacter sp. LPB0142	1850250	S	47	30	77	0.00025
Rhodobacter capsulatus	1061	S	48	10	58	0.00019
Silicimonas algicola	1826607	S	142	15	157	0.00052
Gemmobacter aquarius	2169400	S	63	13	76	0.00025
Gemmobacter fulva	2840474	S	55	11	66	0.00022
Rhodovulum sp. MB263	308754	S	31	14	45	0.00015
Rhodovulum sp. P5	1564506	S	21	4	25	0.00008
Rhodovulum sulfidophilum	35806	S	44	19	63	0.00021
Neotabrizicola shimadae	2807096	S	74	13	87	0.00029
Frigidibacter mobilis	1335048	S	70	34	104	0.00034
Haematobacter massiliensis	195105	S	65	32	97	0.00032
Paroceanicella profunda	2579971	S	59	19	78	0.00026
Tabrizicola piscis	2494374	S	57	7	64	0.00021
Pseudooceanicola atlanticus	1461694	S	34	6	40	0.00013
Pseudooceanicola algae	1537215	S	21	2	23	0.00008
Thioclava nitratireducens	1915078	S	23	11	34	0.00011
Thioclava electrotropha	1549850	S	19	7	26	0.00009
Polymorphum gilvum	991904	S	52	19	71	0.00023
Pelagovum pacificum	2588711	S	48	8	56	0.00018
Fuscovulum blasticum	1075	S	41	8	49	0.00016
Pontivivens ytuae	2789856	S	39	5	44	0.00014
Brevirhabdus pacifica	1267768	S	35	22	57	0.00019
Pikeienuella piscinae	2748098	S	34	4	38	0.00013
Aliiroseovarius crassostreae	154981	S	26	2	28	0.00009
Pukyongiella litopenaei	2605946	S	31	11	42	0.00014
Falsirhodobacter sp. PG104	2692330	S	28	6	34	0.00011
Gymnodinialimonas ceratoperidinii	2856823	S	25	3	28	0.00009
Pontibrevibacter nitratireducens	2758038	S	24	7	31	0.00010
Pacificitalea manganoxidans	1411902	S	23	7	30	0.00010
Pseudopuniceibacterium antarcticum	2613965	S	23	3	26	0.00009
Roseicitreum antarcticum	564137	S	19	1	20	0.00007
Pseudorhodobacter turbinis	2500533	S	18	1	19	0.00006
Yoonia vestfoldensis	245188	S	15	4	19	0.00006
Rhodophyticola sp. CCM32	2916397	S	15	1	16	0.00005
Qingshengfaniella alkalisoli	2599296	S	15	1	16	0.00005
Abyssibius alkaniclasticus	2881234	S	14	1	15	0.00005
Cognatishimia activa	1715691	S	13	0	13	0.00004
Tritonibacter mobilis	379347	S	13	4	17	0.00006
Rhodobaca barguzinensis	441209	S	11	0	11	0.00004
Sulfitobacter sp. JK7-1	2829501	S	19	3	22	0.00007
Sulfitobacter sp. THAF37	2587855	S	15	20	35	0.00012
Sulfitobacter sp. DSM 110093	2883127	S	10	25	35	0.00012
Sulfitobacter sp. JL08	2070369	S	10	1	11	0.00004
Sulfitobacter alexandrii	1917485	S	20	26	46	0.00015
Sulfitobacter faviae	1775881	S	19	22	41	0.00013
Roseovarius sp. SCSIO 43702	2823043	S	34	7	41	0.00013
Roseovarius sp. THAF9	2587847	S	14	13	27	0.00009
Roseovarius sp. THAF8	2587846	S	10	22	32	0.00011
Roseovarius tolerans	74031	S	26	7	33	0.00011
Roseovarius indicus	540747	S	26	23	49	0.00016
Roseovarius faecimaris	2494550	S	19	3	22	0.00007
Leisingera sp. BMJM1	2930199	S	13	15	28	0.00009
Leisingera sp. S132	2867016	S	12	11	23	0.00008
Leisingera aquaemixtae	1396826	S	25	21	46	0.00015
Leisingera caerulea	506591	S	22	16	38	0.00013
Jannaschia sp. W003	2867012	S	63	13	76	0.00025
Jannaschia sp. M317	2867011	S	20	3	23	0.00008
Jannaschia sp. CCS1	290400	S	19	1	20	0.00007
Roseivivax marinus	1379903	S	50	14	64	0.00021
Roseivivax sp. THAF30	2587852	S	20	26	46	0.00015
Salipiger profundus	1229727	S	44	36	80	0.00026
Salipiger sp. CCB-MM3	1792508	S	22	6	28	0.00009
Salipiger abyssi	1250539	S	19	14	33	0.00011
Ruegeria sp. THAF33	2587853	S	13	18	31	0.00010
Ruegeria sp. B32	2867020	S	11	3	14	0.00005
Ruegeria pomeroyi	89184	S	24	8	32	0.00011
Pseudosulfitobacter pseudonitzschiae	1402135	S	35	28	63	0.00021
Pseudosulfitobacter sp. DSM 107133	2883100	S	25	22	47	0.00015
Phaeobacter inhibens	221822	S	20	19	39	0.00013
Phaeobacter gallaeciensis	60890	S	11	13	24	0.00008
Celeribacter indicus	1208324	S	25	20	45	0.00015
Celeribacter ethanolicus	1758178	S	14	6	20	0.00007
Yangia pacifica	311180	S	48	15	63	0.00021
Dinoroseobacter shibae	215813	S	43	38	81	0.00027
Ketogulonicigenium vulgare	92945	S	24	4	28	0.00009
Ketogulonicigenium robustum	92947	S	18	2	20	0.00007
Sagittula sp. P11	2009329	S	42	43	85	0.00028
Ponticoccus alexandrii	1943633	S	37	11	48	0.00016
Actibacterium sp. EMB200-NS6	1609966	S	31	32	63	0.00021
Roseobacter ponti	1891787	S	10	2	12	0.00004
Roseibacterium elongatum	159346	S	24	4	28	0.00009
Thalassococcus sp. S3	2017482	S	21	1	22	0.00007
Tateyamaria omphalii	299262	S	19	2	21	0.00007
Oceanicola sp. D3	2587163	S	17	2	19	0.00006
Loktanella salsilacus	195913	S	17	1	18	0.00006
Mameliella alba	561184	S	16	7	23	0.00008
Antarctobacter heliothermus	74033	S	15	2	17	0.00006
Maribius sp. THAF1	2587842	S	12	1	13	0.00004
Bradyrhizobium sp. 170	2782641	S	181	123	304	0.00100
Bradyrhizobium sp. 200	2782665	S	114	69	183	0.00060
Bradyrhizobium sp. CCBAU 051011	858422	S	53	26	79	0.00026
Bradyrhizobium sp. WD16	1521768	S	44	14	58	0.00019
Bradyrhizobium sp. A19	2898149	S	37	15	52	0.00017
Bradyrhizobium sp. CCBAU 51753	1325100	S	31	16	47	0.00015
Bradyrhizobium sp. ORS 278	114615	S	30	16	46	0.00015
Bradyrhizobium sp. SK17	2057741	S	25	18	43	0.00014
Bradyrhizobium sp. 1(2017)	1404888	S	24	20	44	0.00014
Bradyrhizobium sp. 186	2782654	S	23	16	39	0.00013
Bradyrhizobium sp. BTAi1	288000	S	22	9	31	0.00010
Bradyrhizobium sp. CB1015	2976822	S	18	24	42	0.00014
Bradyrhizobium sp. ORS 285	115808	S	17	9	26	0.00009
Bradyrhizobium sp. CCBAU 53351	1325114	S	15	24	39	0.00013
Bradyrhizobium sp. CB3035	2976824	S	14	11	25	0.00008
Bradyrhizobium sp. 41S5	1404443	S	14	21	35	0.00012
Bradyrhizobium sp. CCGE-LA001	1223566	S	12	11	23	0.00008
Bradyrhizobium sp. I71	2590772	S	11	28	39	0.00013
Bradyrhizobium sp. CCBAU 53340	1325112	S	10	11	21	0.00007
Bradyrhizobium sp. 195	2782662	S	10	9	19	0.00006
Bradyrhizobium sp. CCBAU 53421	1325120	S	10	7	17	0.00006
Bradyrhizobium sediminis	2840469	S	177	67	244	0.00080
Bradyrhizobium erythrophlei	1437360	S	165	32	197	0.00065
Bradyrhizobium diazoefficiens	1355477	S	61	172	233	0.00077
Bradyrhizobium paxllaeri	190148	S	58	26	84	0.00028
Bradyrhizobium icense	1274631	S	53	16	69	0.00023
Bradyrhizobium lablabi	722472	S	42	88	130	0.00043
Bradyrhizobium arachidis	858423	S	40	105	145	0.00048
Bradyrhizobium canariense	255045	S	32	96	128	0.00042
Bradyrhizobium oligotrophicum	44255	S	28	10	38	0.00013
Bradyrhizobium japonicum	375	S	25	81	106	0.00035
Bradyrhizobium genosp. L	83637	S	23	10	33	0.00011
Bradyrhizobium quebecense	2748629	S	23	29	52	0.00017
Bradyrhizobium guangzhouense	1325095	S	23	26	49	0.00016
Bradyrhizobium barranii	2992140	S	22	72	94	0.00031
Bradyrhizobium genosp. B	83627	S	19	10	29	0.00010
Bradyrhizobium betae	244734	S	17	64	81	0.00027
Bradyrhizobium vignae	1549949	S	15	9	24	0.00008
Bradyrhizobium daqingense	993502	S	14	17	31	0.00010
Bradyrhizobium septentrionale	1404411	S	13	17	30	0.00010
Bradyrhizobium cosmicum	1404864	S	13	10	23	0.00008
Bradyrhizobium guangdongense	1325090	S	12	14	26	0.00009
Bradyrhizobium symbiodeficiens	1404367	S	12	39	51	0.00017
Rhodopseudomonas palustris	1076	S	161	81	242	0.00080
Rhodopseudomonas sp. P2A-2r	2991972	S	34	14	48	0.00016
Rhodopseudomonas sp. SK50-23	340268	S	14	5	19	0.00006
Rhodopseudomonas boonkerdii	475937	S	13	5	18	0.00006
Afipia carboxidovorans	40137	S	26	18	44	0.00014
Afipia sp. GAS231	1882747	S	22	24	46	0.00015
Variibacter gotjawalensis	1333996	S	44	7	51	0.00017
Nitrobacter hamburgensis	912	S	16	5	21	0.00007
Nitrobacter winogradskyi	913	S	12	4	16	0.00005
Methylobacterium sp. FF17	2984843	S	142	43	185	0.00061
Methylobacterium sp. WL1	2603276	S	122	55	177	0.00058
Methylobacterium sp. 4-46	426117	S	55	20	75	0.00025
Methylobacterium sp. 17Sr1-1	2202826	S	29	29	58	0.00019
Methylobacterium sp. NMS14P	2894310	S	10	16	26	0.00009
Methylobacterium aquaticum	270351	S	56	50	106	0.00035
Methylobacterium nodulans	114616	S	49	12	61	0.00020
Methylobacterium radiodurans	2202828	S	46	20	66	0.00022
Methylobacterium brachiatum	269660	S	45	34	79	0.00026
Methylobacterium durans	2202825	S	45	13	58	0.00019
Methylobacterium mesophilicum	39956	S	38	19	57	0.00019
Methylobacterium organophilum	410	S	31	25	56	0.00018
Methylobacterium indicum	1775910	S	31	30	61	0.00020
Methylobacterium tardum	374432	S	30	22	52	0.00017
Methylobacterium currus	2051553	S	25	20	45	0.00015
Methylobacterium terrae	2202827	S	24	23	47	0.00015
Methylobacterium oryzae	334852	S	19	68	87	0.00029
Methylobacterium radiotolerans	31998	S	10	76	86	0.00028
Microvirga ossetica	1882682	S	315	81	396	0.00130
Microvirga sp. R24	2740529	S	104	39	143	0.00047
Microvirga sp. VF16	2807101	S	100	27	127	0.00042
Microvirga sp. 17 mud 1-3	2082949	S	47	16	63	0.00021
Microvirga thermotolerans	2651334	S	62	29	91	0.00030
Methylorubrum extorquens	408	S	76	130	206	0.00068
Methylorubrum populi	223967	S	72	48	120	0.00040
Methylorubrum sp. B1-46	2897334	S	24	15	39	0.00013
Rhizobium sp. WL3	2603277	S	29	16	45	0.00015
Rhizobium sp. TH2	2775403	S	26	6	32	0.00011
Rhizobium sp. SL42	2806346	S	18	6	24	0.00008
Rhizobium sp. BG4	2613770	S	16	7	23	0.00008
Rhizobium sp. ACO-34A	1571470	S	14	6	20	0.00007
Rhizobium sp. SSM4.3	2919917	S	12	6	18	0.00006
Rhizobium sp. C104	2917727	S	12	37	49	0.00016
Rhizobium sp. NLR16a	2731112	S	10	28	38	0.00013
Rhizobium leguminosarum	384	S	69	169	238	0.00078
Rhizobium rosettiformans	1368430	S	24	19	43	0.00014
Rhizobium pseudoryzae	379684	S	16	6	22	0.00007
Rhizobium rhizoryzae	451876	S	14	3	17	0.00006
Rhizobium etli	29449	S	13	13	26	0.00009
Rhizobium phaseoli	396	S	12	47	59	0.00019
Rhizobium lentis	1138194	S	12	9	21	0.00007
Rhizobium jaguaris	1312183	S	11	2	13	0.00004
Agrobacterium tumefaciens	358	S	68	104	172	0.00057
Agrobacterium vaccinii	2735528	S	72	20	92	0.00030
Agrobacterium sp. MA01	2664893	S	10	19	29	0.00010
Agrobacterium vitis	373	S	21	30	51	0.00017
Agrobacterium rubi	28099	S	18	12	30	0.00010
Agrobacterium larrymoorei	160699	S	14	4	18	0.00006
Neorhizobium galegae	399	S	56	20	76	0.00025
Neorhizobium sp. NCHU2750	1825976	S	22	10	32	0.00011
Neorhizobium sp. SOG26	2060726	S	14	4	18	0.00006
Pseudorhizobium banfieldiae	1125847	S	17	15	32	0.00011
Pseudorhizobium flavum	1335061	S	16	13	29	0.00010
Pararhizobium sp. BT-229	2986923	S	21	6	27	0.00009
Pararhizobium sp. YC-54	2986920	S	17	6	23	0.00008
Ensifer adhaerens	106592	S	51	46	97	0.00032
Ensifer alkalisoli	1752398	S	20	8	28	0.00009
Ensifer mexicanus	375549	S	16	4	20	0.00007
Ensifer sojae	716925	S	14	10	24	0.00008
Ensifer sp. PDNC004	2811423	S	14	8	22	0.00007
Sinorhizobium fredii	380	S	33	56	89	0.00029
Sinorhizobium medicae	110321	S	26	22	48	0.00016
Sinorhizobium meliloti	382	S	24	9	33	0.00011
Sinorhizobium sp. BG8	2613773	S	10	2	12	0.00004
Sinorhizobium americanum	194963	S	11	8	19	0.00006
Shinella sp. XGS7	2877941	S	27	26	53	0.00017
Shinella sp. HZN7	879274	S	24	33	57	0.00019
Shinella sp. PSBB067	2715959	S	15	20	35	0.00012
Shinella zoogloeoides	352475	S	18	35	53	0.00017
Shinella oryzae	2871820	S	15	12	27	0.00009
Georhizobium profundi	2341112	S	19	6	25	0.00008
Ciceribacter thiooxidans	1969821	S	13	4	17	0.00006
Mesorhizobium sp. 8	2584466	S	32	16	48	0.00016
Mesorhizobium sp. M1E.F.Ca.ET.045.02.1.1	2493672	S	26	31	57	0.00019
Mesorhizobium sp. L-2-11	2744521	S	20	25	45	0.00015
Mesorhizobium sp. DCY119	2108445	S	20	10	30	0.00010
Mesorhizobium sp. B2-1-1	2589974	S	20	12	32	0.00011
Mesorhizobium sp. AR07	2865838	S	18	21	39	0.00013
Mesorhizobium sp. J8	2777475	S	18	14	32	0.00011
Mesorhizobium sp. M9A.F.Ca.ET.002.03.1.2	2493668	S	17	22	39	0.00013
Mesorhizobium sp. PAMC28654	2880934	S	16	8	24	0.00008
Mesorhizobium sp. NBSH29	2654249	S	16	3	19	0.00006
Mesorhizobium sp. Pch-S	2082387	S	16	4	20	0.00007
Mesorhizobium sp. INR15	2654248	S	15	6	21	0.00007
Mesorhizobium sp. M8A.F.Ca.ET.057.01.1.1	2493679	S	15	19	34	0.00011
Mesorhizobium sp. B4-1-4	2589888	S	15	11	26	0.00009
Mesorhizobium sp. M3A.F.Ca.ET.080.04.2.1	2493676	S	14	11	25	0.00008
Mesorhizobium sp. M1D.F.Ca.ET.043.01.1.1	2493669	S	13	18	31	0.00010
Mesorhizobium sp. AR02	2865837	S	13	21	34	0.00011
Mesorhizobium sp. AR10	2865839	S	13	10	23	0.00008
Mesorhizobium sp. B2-1-8	2589967	S	13	11	24	0.00008
Mesorhizobium sp. B2-8-5	2589903	S	13	10	23	0.00008
Mesorhizobium sp. M1A.F.Ca.IN.022.06.1.1	2493680	S	13	12	25	0.00008
Mesorhizobium sp. L-8-10	2744523	S	12	67	79	0.00026
Mesorhizobium sp. M6A.T.Cr.TU.016.01.1.1	2493677	S	11	13	24	0.00008
Mesorhizobium sp. M7D.F.Ca.US.005.01.1.1	2493678	S	10	13	23	0.00008
Mesorhizobium sp. NZP2298	2483403	S	10	21	31	0.00010
Mesorhizobium sp. B1-1-8	2589976	S	10	6	16	0.00005
Mesorhizobium sp. M4B.F.Ca.ET.058.02.1.1	2493675	S	10	11	21	0.00007
Mesorhizobium amorphae	71433	S	21	15	36	0.00012
Mesorhizobium terrae	2725666	S	18	10	28	0.00009
Mesorhizobium opportunistum	593909	S	14	20	34	0.00011
Mesorhizobium erdmanii	1777866	S	10	13	23	0.00008
Mesorhizobium japonicum	2066070	S	10	30	40	0.00013
Aquibium microcysteis	675281	S	41	20	61	0.00020
Aquibium oceanicum	1670800	S	39	16	55	0.00018
Phyllobacterium sp. A18/5-2	2978392	S	20	5	25	0.00008
Phyllobacterium sp. T1018	555316	S	11	2	13	0.00004
Phyllobacterium zundukense	1867719	S	29	8	37	0.00012
Nitratireductor sp. SY7	2599600	S	36	15	51	0.00017
Nitratireductor sp. OM-1	1756988	S	15	4	19	0.00006
Nitratireductor kimnyeongensis	430679	S	10	2	12	0.00004
Aminobacter sp. MSH1	374606	S	15	16	31	0.00010
Aminobacter sp. NyZ550	2979870	S	10	57	67	0.00022
Hoeflea phototrophica	244596	S	10	2	12	0.00004
Hoeflea sp. IMCC20628	1620421	S	10	1	11	0.00004
Oricola thermophila	2742145	S	14	3	17	0.00006
Roseitalea porphyridii	1852022	S	12	4	16	0.00005
Devosia sp. A16	1736675	S	63	14	77	0.00025
Devosia sp. JXJ CY 41	2917991	S	37	13	50	0.00016
Devosia sp. SL43	2806348	S	36	13	49	0.00016
Devosia sp. 1566	2499144	S	29	6	35	0.00012
Devosia sp. I507	2083786	S	17	8	25	0.00008
Devosia beringensis	2657486	S	46	17	63	0.00021
Devosia ginsengisoli	400770	S	43	19	62	0.00020
Devosia neptuniae	191302	S	35	9	44	0.00014
Devosia oryziradicis	2801335	S	33	14	47	0.00015
Devosia rhizoryzae	2774137	S	30	7	37	0.00012
Devosia salina	2860336	S	21	12	33	0.00011
Pelagibacterium sp. YIM 151497	2984530	S	19	5	24	0.00008
Pelagibacterium halotolerans	531813	S	12	2	14	0.00005
Paradevosia shaoguanensis	1335043	S	23	9	32	0.00011
Youhaiella tibetensis	1447062	S	22	6	28	0.00009
Ancylobacter sp. TS-1	1850374	S	21	14	35	0.00012
Ancylobacter sp. SL191	2995166	S	19	9	28	0.00009
Ancylobacter polymorphus	223390	S	37	29	66	0.00022
Ancylobacter pratisalsi	1745854	S	19	7	26	0.00009
Xanthobacter dioxanivorans	2528964	S	38	22	60	0.00020
Xanthobacter sp. YC-JY1	2419844	S	17	20	37	0.00012
Xanthobacter autotrophicus	280	S	14	18	32	0.00011
Pseudolabrys taiwanensis	331696	S	47	13	60	0.00020
Pseudolabrys sp. FHR47	2562284	S	32	10	42	0.00014
Starkeya novella	921	S	27	17	44	0.00014
Starkeya sp. ORNL1	2709380	S	26	9	35	0.00012
Labrys sp. KNU-23	2789216	S	39	8	47	0.00015
Azorhizobium caulinodans	7	S	30	10	40	0.00013
Aquabacter sp. L1I39	2820278	S	20	5	25	0.00008
Bosea sp. RAC05	1842539	S	60	29	89	0.00029
Bosea sp. Tri-49	1867715	S	38	15	53	0.00017
Bosea sp. NBC_00550	2969621	S	38	21	59	0.00019
Bosea sp. F3-2	2599640	S	35	20	55	0.00018
Bosea sp. PAMC 26642	1792307	S	34	13	47	0.00015
Bosea sp. AS-1	2015316	S	26	14	40	0.00013
Bosea sp. ANAM02	2020412	S	25	17	42	0.00014
Bosea sp. NBC_00436	2969620	S	24	17	41	0.00013
Bosea vaviloviae	1526658	S	48	20	68	0.00022
Aureimonas sp. SA4125	2826993	S	47	15	62	0.00020
Aureimonas sp. AU20	1349819	S	28	8	36	0.00012
Aureimonas populi	1701758	S	19	8	27	0.00009
Aureimonas mangrovi	2758041	S	13	5	18	0.00006
Aureimonas altamirensis	370622	S	11	12	23	0.00008
Aurantimonas sp. HBX-1	2906072	S	100	46	146	0.00048
Martelella mediterranea	293089	S	21	12	33	0.00011
Martelella endophytica	1486262	S	14	5	19	0.00006
Martelella lutilitoris	2583532	S	13	12	25	0.00008
Jiella sp. HL-NP1	2986949	S	45	11	56	0.00018
Hyphomicrobium sp. DMF-1	3019544	S	21	3	24	0.00008
Hyphomicrobium sp. MC1	717785	S	13	1	14	0.00005
Hyphomicrobium denitrificans	53399	S	22	3	25	0.00008
Hyphomicrobium nitrativorans	1427356	S	19	3	22	0.00007
Rhodoplanes sp. Z2-YC6860	674703	S	61	12	73	0.00024
Caenibius sp. WL	2872646	S	32	8	40	0.00013
Caenibius tardaugens	169176	S	24	19	43	0.00014
Methyloceanibacter caenitepidi	1384459	S	11	6	17	0.00006
Methyloligella sp. GL2	2742204	S	23	4	27	0.00009
Rhodomicrobium vannielii	1069	S	18	2	20	0.00007
Methylocystis sp. MJC1	2654282	S	15	3	18	0.00006
Methylocystis sp. SC2	187303	S	14	9	23	0.00008
Methylocystis parvus	134	S	15	3	18	0.00006
Methylocystis rosea	173366	S	12	22	34	0.00011
Methylocystis heyeri	391905	S	11	2	13	0.00004
Methylocystis bryophila	655015	S	11	2	13	0.00004
Chenggangzhangella methanolivorans	1437009	S	42	12	54	0.00018
Methylosinus trichosporium	426	S	19	7	26	0.00009
Methylosinus sp. C49	2699395	S	14	5	19	0.00006
Stappia indica	538381	S	30	11	41	0.00013
Stappia sp. ES.058	1881061	S	21	4	25	0.00008
Pannonibacter phragmitetus	121719	S	38	30	68	0.00022
Roseibium aggregatum	187304	S	19	4	23	0.00008
Roseibium sp. Sym1	3016006	S	16	7	23	0.00008
Labrenzia sp. VG12	2021862	S	13	3	16	0.00005
Pseudorhodoplanes sinuspersici	1235591	S	47	7	54	0.00018
Nordella sp. HKS 07	2712222	S	38	4	42	0.00014
Terrihabitans soli	708113	S	33	7	40	0.00013
Phreatobacter cathodiphilus	1868589	S	41	21	62	0.00020
Phreatobacter stygius	1940610	S	40	12	52	0.00017
Phreatobacter sp. NMCR1094	2570229	S	25	9	34	0.00011
Chelatococcus sp. CO-6	1702325	S	51	40	91	0.00030
Chelatococcus daeguensis	444444	S	21	16	37	0.00012
Kaustia mangrovi	2593653	S	36	7	43	0.00014
Pyruvatibacter mobilis	1712261	S	20	4	24	0.00008
Parvibaculum lavamentivorans	256618	S	18	10	28	0.00009
Methylocella silvestris	199596	S	25	7	32	0.00011
Methylocella tundrae	227605	S	14	3	17	0.00006
Methylovirgula ligni	569860	S	13	3	16	0.00005
Blastochloris viridis	1079	S	20	11	31	0.00010
Blastochloris tepida	2233851	S	16	10	26	0.00009
Acuticoccus sp. I52.16.1	2928472	S	38	7	45	0.00015
Kaistia sp. 32K	2795690	S	33	14	47	0.00015
Hartmannibacter diazotrophicus	1482074	S	27	8	35	0.00012
Lichenihabitans sp. PAMC28606	2880932	S	10	11	21	0.00007
Breoghania sp. L-A4	2304600	S	14	3	17	0.00006
Roseomonas sp. OT10	2897332	S	121	47	168	0.00055
Roseomonas sp. S08	1750527	S	109	18	127	0.00042
Roseomonas haemaphysalidis	2768162	S	123	25	148	0.00049
Roseomonas cervicalis	204525	S	118	44	162	0.00053
Roseomonas gilardii	257708	S	78	37	115	0.00038
Roseomonas marmotae	2768161	S	61	12	73	0.00024
Roseomonas mucosa	207340	S	30	200	230	0.00076
Roseococcus microcysteis	2771361	S	145	47	192	0.00063
Sediminicoccus rosea	1225128	S	85	17	102	0.00034
Rhodovastum atsumiense	504468	S	52	10	62	0.00020
Komagataeibacter xylinus	28448	S	10	50	60	0.00020
Lichenicola cladoniae	1484109	S	29	2	31	0.00010
Acidocella sp. MX-AZ03	2697363	S	28	4	32	0.00011
Gluconacetobacter diazotrophicus	33996	S	15	10	25	0.00008
Granulibacter bethesdensis	364410	S	11	1	12	0.00004
Acidibrevibacterium fodinaquatile	1969806	S	11	1	12	0.00004
Azospirillum sp. B510	137722	S	20	11	31	0.00010
Azospirillum sp. TSH100	652764	S	14	9	23	0.00008
Azospirillum sp. TSA2s	709810	S	13	14	27	0.00009
Azospirillum thermophilum	2202148	S	40	14	54	0.00018
Azospirillum brasilense	192	S	31	50	81	0.00027
Azospirillum thiophilum	528244	S	24	12	36	0.00012
Azospirillum argentinense	2970906	S	23	45	68	0.00022
Azospirillum ramasamyi	682998	S	21	17	38	0.00013
Azospirillum humicireducens	1226968	S	13	10	23	0.00008
Skermanella sp. TT6	2775420	S	54	61	115	0.00038
Skermanella mucosa	1789672	S	47	35	82	0.00027
Skermanella rosea	1817965	S	40	37	77	0.00025
Skermanella pratensis	2233999	S	36	24	60	0.00020
Indioceanicola profundi	2220096	S	31	6	37	0.00012
Nitrospirillum amazonense	28077	S	23	4	27	0.00009
Magnetospirillum sp. ME-1	1639348	S	10	9	19	0.00006
Magnetospirillum sp. XM-1	1663591	S	10	8	18	0.00006
Magnetospirillum gryphiswaldense	55518	S	18	4	22	0.00007
Hypericibacter terrae	2602015	S	29	6	35	0.00012
Hypericibacter adhaerens	2602016	S	24	6	30	0.00010
Rhodospirillum centenum	34018	S	23	10	33	0.00011
Rhodospirillum rubrum	1085	S	18	5	23	0.00008
Ferrovibrio terrae	2594003	S	24	4	28	0.00009
Defluviicoccus vanus	111831	S	15	2	17	0.00006
Pararhodospirillum photometricum	1084	S	13	4	17	0.00006
Stella humosa	94	S	51	9	60	0.00020
Tistrella mobilis	171437	S	30	14	44	0.00014
Elioraea tepida	2843330	S	28	7	35	0.00012
Nisaea acidiphila	1862145	S	16	2	18	0.00006
Brevundimonas sp. NIBR10	3015997	S	52	12	64	0.00021
Brevundimonas sp. M20	2591463	S	49	13	62	0.00020
Brevundimonas sp. LM2	1938605	S	38	12	50	0.00016
Brevundimonas sp. NIBR11	3015999	S	35	9	44	0.00014
Brevundimonas sp. MF30-B	2561924	S	34	10	44	0.00014
Brevundimonas sp. PAMC22021	2861285	S	31	11	42	0.00014
Brevundimonas sp. SL130	2995143	S	25	13	38	0.00013
Brevundimonas sp. GW460-12-10-14-LB2	1827469	S	15	60	75	0.00025
Brevundimonas sp. AJA228-03	2752515	S	15	8	23	0.00008
Brevundimonas sp. CS1	2813778	S	11	27	38	0.00013
Brevundimonas subvibrioides	74313	S	58	22	80	0.00026
Brevundimonas naejangsanensis	588932	S	44	23	67	0.00022
Brevundimonas goettingensis	2774190	S	39	10	49	0.00016
Brevundimonas albigilva	1312364	S	34	24	58	0.00019
Brevundimonas vesicularis	41276	S	33	89	122	0.00040
Brevundimonas diminuta	293	S	26	65	91	0.00030
Brevundimonas mediterranea	74329	S	25	26	51	0.00017
Brevundimonas pondensis	2774189	S	25	11	36	0.00012
Brevundimonas vitisensis	2800818	S	23	4	27	0.00009
Brevundimonas nasdae	172043	S	21	11	32	0.00011
Caulobacter sp. S6	2823693	S	47	10	57	0.00019
Caulobacter sp. NIBR1757	3016000	S	31	9	40	0.00013
Caulobacter sp. NIBR2454	3015996	S	25	8	33	0.00011
Caulobacter sp. FWC26	69665	S	24	17	41	0.00013
Caulobacter segnis	88688	S	65	35	100	0.00033
Caulobacter flavus	1679497	S	34	16	50	0.00016
Caulobacter mirabilis	69666	S	33	10	43	0.00014
Caulobacter rhizosphaerae	2010972	S	31	16	47	0.00015
Caulobacter vibrioides	155892	S	28	21	49	0.00016
Caulobacter soli	2708539	S	25	13	38	0.00013
Caulobacter henricii	69395	S	21	6	27	0.00009
Phenylobacterium sp. LH3H17	2903901	S	100	29	129	0.00042
Phenylobacterium sp. NIBR 498073	3015177	S	55	22	77	0.00025
Phenylobacterium zucineum	284016	S	73	30	103	0.00034
Phenylobacterium parvum	2201350	S	18	4	22	0.00007
Asticcacaulis sp. AND118	2840468	S	10	1	11	0.00004
Asticcacaulis excentricus	78587	S	11	0	11	0.00004
Terricaulis silvestris	2686094	S	15	0	15	0.00005
Marinicauda algicola	2029849	S	25	6	31	0.00010
Hyphomonas neptunium	81032	S	10	1	11	0.00004
Candidatus Viadribacter manganicus	1759059	S	10	0	10	0.00003
Variovorax sp. PAMC 28711	1795631	S	141	64	205	0.00067
Variovorax sp. HW608	1034889	S	120	50	170	0.00056
Variovorax sp. PAMC28562	2762323	S	82	19	101	0.00033
Variovorax sp. PBS-H4	434008	S	79	76	155	0.00051
Variovorax sp. RA8	662548	S	78	95	173	0.00057
Variovorax sp. WDL1	207745	S	73	137	210	0.00069
Variovorax sp. PAMC26660	2762322	S	73	54	127	0.00042
Variovorax sp. PBL-H6	434009	S	70	142	212	0.00070
Variovorax sp. RKNM96	2681552	S	59	63	122	0.00040
Variovorax sp. SRS16	282217	S	41	156	197	0.00065
Variovorax sp. 38R	2774875	S	35	84	119	0.00039
Variovorax sp. PBL-E5	434014	S	32	154	186	0.00061
Variovorax sp. WS11	1105204	S	18	3	21	0.00007
Variovorax paradoxus	34073	S	496	589	1085	0.00357
Variovorax boronicumulans	436515	S	28	54	82	0.00027
Hydrogenophaga sp. RAC07	1842537	S	210	132	342	0.00113
Hydrogenophaga sp. SL48	2806347	S	158	83	241	0.00079
Hydrogenophaga sp. PBL-H3	434010	S	109	146	255	0.00084
Hydrogenophaga sp. BPS33	2651974	S	89	78	167	0.00055
Hydrogenophaga sp. YM1	2806262	S	73	66	139	0.00046
Hydrogenophaga sp. PBC	795665	S	67	75	142	0.00047
Hydrogenophaga sp. NH-16	2184519	S	49	152	201	0.00066
Hydrogenophaga sp. PAMC20947	2565558	S	32	5	37	0.00012
Hydrogenophaga taeniospiralis	65656	S	92	52	144	0.00047
Hydrogenophaga crocea	2716225	S	80	81	161	0.00053
Hydrogenophaga pseudoflava	47421	S	39	102	141	0.00046
Hydrogenophaga crassostreae	1763535	S	39	6	45	0.00015
Acidovorax sp. JMULE5	2518343	S	116	67	183	0.00060
Acidovorax sp. RAC01	1842533	S	86	79	165	0.00054
Acidovorax sp. KKS102	358220	S	72	75	147	0.00048
Acidovorax sp. GBBC 1281	2940492	S	52	62	114	0.00038
Acidovorax sp. 1608163	2478662	S	50	24	74	0.00024
Acidovorax sp. T1	1858609	S	49	191	240	0.00079
Acidovorax sp. YS12	2738413	S	49	63	112	0.00037
Acidovorax sp. NCPPB 2350	2940487	S	43	31	74	0.00024
Acidovorax sp. 5MLIR	2949090	S	40	26	66	0.00022
Acidovorax sp. NCPPB 3576	2940488	S	28	30	58	0.00019
Acidovorax sp. HDW3	2714923	S	26	24	50	0.00016
Acidovorax antarcticus	2743470	S	78	74	152	0.00050
Acidovorax carolinensis	553814	S	66	98	164	0.00054
Acidovorax avenae	80867	S	59	174	233	0.00077
Acidovorax temperans	80878	S	58	107	165	0.00054
Acidovorax radicis	758826	S	42	18	60	0.00020
Acidovorax monticola	1926868	S	40	37	77	0.00025
Acidovorax citrulli	80869	S	22	35	57	0.00019
Acidovorax cattleyae	80868	S	19	24	43	0.00014
Ramlibacter tataouinensis	94132	S	697	450	1147	0.00378
Polaromonas naphthalenivorans	216465	S	281	89	370	0.00122
Polaromonas sp. JS666	296591	S	71	92	163	0.00054
Polaromonas vacuolata	37448	S	11	1	12	0.00004
Rhodoferax sp. BAB1	2741720	S	76	50	126	0.00041
Rhodoferax sp. AJA081-3	2752316	S	24	4	28	0.00009
Rhodoferax sp. MIZ03	2798804	S	21	3	24	0.00008
Rhodoferax sp. PAMC 29310	2822760	S	21	3	24	0.00008
Rhodoferax koreense	1842727	S	120	118	238	0.00078
Rhodoferax sediminis	2509614	S	76	33	109	0.00036
Rhodoferax antarcticus	81479	S	31	4	35	0.00012
Rhodoferax ferrireducens	192843	S	27	4	31	0.00010
Rhodoferax saidenbachensis	1484693	S	27	8	35	0.00012
Comamonas aquatica	225991	S	89	112	201	0.00066
Comamonas sp. NLF-7-7	2597701	S	22	26	48	0.00016
Comamonas sp. NLF-1-9	2853163	S	20	16	36	0.00012
Comamonas sp. B21-038	2918299	S	14	7	21	0.00007
Comamonas sp. Y33R10-2	2853257	S	10	2	12	0.00004
Comamonas thiooxydans	363952	S	24	71	95	0.00031
Comamonas serinivorans	1082851	S	23	10	33	0.00011
Comamonas piscis	1562974	S	22	9	31	0.00010
Comamonas odontotermitis	379895	S	21	7	28	0.00009
Comamonas testosteroni	285	S	19	107	126	0.00041
Comamonas kerstersii	225992	S	16	8	24	0.00008
Comamonas fluminis	2796366	S	16	9	25	0.00008
Diaphorobacter sp. HDW4A	2714924	S	30	42	72	0.00024
Diaphorobacter sp. HDW4B	2714925	S	22	16	38	0.00013
Diaphorobacter ruginosibacter	1715720	S	47	43	90	0.00030
Diaphorobacter aerolatus	1288495	S	21	42	63	0.00021
Delftia tsuruhatensis	180282	S	35	118	153	0.00050
Delftia acidovorans	80866	S	25	79	104	0.00034
Delftia lacustris	558537	S	14	98	112	0.00037
Ottowia testudinis	2816950	S	58	24	82	0.00027
Ottowia oryzae	2109914	S	42	20	62	0.00020
Ottowia sp. oral taxon 894	1658672	S	26	7	33	0.00011
Kinneretia sp. DAIF2	2714952	S	90	62	152	0.00050
Alicycliphilus denitrificans	179636	S	77	189	266	0.00088
Melaminivora jejuensis	1267217	S	36	37	73	0.00024
Melaminivora suipulveris	2109913	S	34	47	81	0.00027
Serpentinimonas maccroryi	1458426	S	31	14	45	0.00015
Serpentinimonas raichei	1458425	S	30	13	43	0.00014
Hylemonella gracilis	80880	S	45	16	61	0.00020
Limnohabitans sp. 63ED37-2	1678128	S	35	8	43	0.00014
Limnohabitans sp. 103DPR2	1678129	S	10	1	11	0.00004
Verminephrobacter eiseniae	364317	S	38	12	50	0.00016
Simplicispira suum	2109915	S	32	19	51	0.00017
Pulveribacter suum	2116657	S	26	30	56	0.00018
Curvibacter sp. AEP1-3	1844971	S	22	3	25	0.00008
Candidatus Symbiobacter mobilis	1436290	S	10	0	10	0.00003
Massilia sp. LPB0304	2769491	S	333	239	572	0.00188
Massilia sp. H6	2970464	S	223	116	339	0.00112
Massilia sp. PAMC28688	2861283	S	176	68	244	0.00080
Massilia sp. WG5	1707785	S	127	112	239	0.00079
Massilia sp. NP310	2861282	S	115	158	273	0.00090
Massilia sp. HC52	2852099	S	77	55	132	0.00043
Massilia sp. DM-R-R2A-13	2899220	S	62	36	98	0.00032
Massilia sp. YMA4	1593482	S	53	72	125	0.00041
Massilia sp. erpn	2738142	S	40	173	213	0.00070
Massilia violaceinigra	2045208	S	194	119	313	0.00103
Massilia forsythiae	2728020	S	94	58	152	0.00050
Massilia oculi	945844	S	74	90	164	0.00054
Massilia putida	1141883	S	70	38	108	0.00036
Massilia antarctica	2765360	S	50	41	91	0.00030
Pseudoduganella lutea	321985	S	95	58	153	0.00050
Pseudoduganella umbonata	864828	S	61	47	108	0.00036
Pseudoduganella flava	871742	S	60	33	93	0.00031
Pseudoduganella albidiflava	321983	S	59	46	105	0.00035
Pseudoduganella plicata	321984	S	53	31	84	0.00028
Pseudoduganella armeniaca	2072590	S	42	52	94	0.00031
Duganella dendranthematis	2728021	S	48	20	68	0.00022
Herbaspirillum robiniae	2014887	S	64	54	118	0.00039
Herbaspirillum hiltneri	341045	S	45	22	67	0.00022
Herbaspirillum huttiense	863372	S	39	33	72	0.00024
Herbaspirillum seropedicae	964	S	32	27	59	0.00019
Herbaspirillum frisingense	92645	S	31	23	54	0.00018
Herbaspirillum rubrisubalbicans	80842	S	26	20	46	0.00015
Herbaspirillum sp. meg3	2025949	S	18	5	23	0.00008
Janthinobacterium sp. 17J80-10	2497863	S	53	18	71	0.00023
Janthinobacterium sp. 1_2014MBL_MicDiv	1644131	S	25	24	49	0.00016
Janthinobacterium sp. LM6	1938606	S	19	28	47	0.00015
Janthinobacterium sp. Marseille	375286	S	18	8	26	0.00009
Janthinobacterium agaricidamnosum	55508	S	75	71	146	0.00048
Janthinobacterium tructae	2590869	S	13	22	35	0.00012
Collimonas fungivorans	158899	S	44	22	66	0.00022
Collimonas arenae	279058	S	40	12	52	0.00017
Collimonas pratensis	279113	S	30	15	45	0.00015
Noviherbaspirillum sp. UKPF54	2601898	S	70	29	99	0.00033
Undibacterium sp. KW1	2058624	S	11	9	20	0.00007
Herminiimonas arsenitoxidans	1809410	S	10	3	13	0.00004
Burkholderia ubonensis	101571	S	34	48	82	0.00027
Burkholderia multivorans	87883	S	32	37	69	0.00023
Burkholderia cepacia	292	S	25	53	78	0.00026
Burkholderia pyrrocinia	60550	S	23	37	60	0.00020
Burkholderia contaminans	488447	S	20	44	64	0.00021
Burkholderia cenocepacia	95486	S	20	171	191	0.00063
Burkholderia ambifaria	152480	S	11	24	35	0.00012
Burkholderia sp. FERM BP-3421	1494466	S	29	20	49	0.00016
Burkholderia sp. DHOD12	2571746	S	16	6	22	0.00007
Burkholderia sp. Bp7605	1740163	S	13	6	19	0.00006
Burkholderia gladioli	28095	S	63	56	119	0.00039
Burkholderia oklahomensis	342113	S	11	15	26	0.00009
Burkholderia pseudomallei	28450	S	10	45	55	0.00018
Burkholderia thailandensis	57975	S	10	9	19	0.00006
Burkholderia plantarii	41899	S	22	21	43	0.00014
Burkholderia glumae	337	S	19	11	30	0.00010
Cupriavidus taiwanensis	164546	S	92	156	248	0.00082
Cupriavidus pauculus	82633	S	75	54	129	0.00042
Cupriavidus sp. EM10	2839983	S	25	24	49	0.00016
Cupriavidus sp. P-10	2027911	S	13	13	26	0.00009
Cupriavidus basilensis	68895	S	43	40	83	0.00027
Cupriavidus necator	106590	S	42	51	93	0.00031
Cupriavidus campinensis	151783	S	38	25	63	0.00021
Cupriavidus oxalaticus	96344	S	24	22	46	0.00015
Cupriavidus gilardii	82541	S	20	110	130	0.00043
Cupriavidus cauae	2608999	S	19	23	42	0.00014
Cupriavidus pinatubonensis	248026	S	15	4	19	0.00006
Cupriavidus metallidurans	119219	S	13	10	23	0.00008
Cupriavidus neocaledonicus	1040979	S	10	24	34	0.00011
Paraburkholderia sp. SOS3	1926494	S	16	8	24	0.00008
Paraburkholderia pallida	2547399	S	22	8	30	0.00010
Paraburkholderia fungorum	134537	S	21	14	35	0.00012
Paraburkholderia terricola	169427	S	17	11	28	0.00009
Paraburkholderia acidisoli	2571748	S	16	7	23	0.00008
Paraburkholderia acidiphila	2571747	S	16	7	23	0.00008
Paraburkholderia ginsengisoli	311231	S	16	11	27	0.00009
Paraburkholderia caribensis	75105	S	14	16	30	0.00010
Paraburkholderia xenovorans	36873	S	13	21	34	0.00011
Paraburkholderia phytofirmans	261302	S	13	13	26	0.00009
Paraburkholderia tropica	92647	S	11	5	16	0.00005
Paraburkholderia edwinii	2861782	S	11	3	14	0.00005
Paraburkholderia dokdonella	2211211	S	11	6	17	0.00006
Paraburkholderia graminis	60548	S	10	5	15	0.00005
Paraburkholderia atlantica	2654982	S	10	5	15	0.00005
Paraburkholderia aromaticivorans	2026199	S	10	8	18	0.00006
Paraburkholderia sprentiae	948107	S	10	4	14	0.00005
Ralstonia solanacearum	305	S	52	307	359	0.00118
Ralstonia pickettii	329	S	18	13	31	0.00010
Ralstonia insidiosa	190721	S	14	9	23	0.00008
Pandoraea pnomenusa	93220	S	21	24	45	0.00015
Pandoraea thiooxydans	445709	S	15	3	18	0.00006
Pandoraea pulmonicola	93221	S	14	8	22	0.00007
Pandoraea apista	93218	S	12	12	24	0.00008
Pandoraea norimbergensis	93219	S	10	4	14	0.00005
Caballeronia sp. Lep1P3	2878150	S	14	23	37	0.00012
Caballeronia sp. TF1N1	2878153	S	11	6	17	0.00006
Caballeronia zhejiangensis	871203	S	19	8	27	0.00009
Caballeronia grimmiae	1071679	S	15	10	25	0.00008
Caballeronia insecticola	758793	S	14	5	19	0.00006
Polynucleobacter asymbioticus	576611	S	11	14	25	0.00008
Chitinimonas koreensis	356302	S	40	15	55	0.00018
Chitinimonas arctica	2594795	S	12	1	13	0.00004
Limnobacter sp. SAORIC-580	2732163	S	35	1	36	0.00012
Lautropia mirabilis	47671	S	34	9	43	0.00014
Aquincola tertiaricarbonis	391953	S	221	148	369	0.00121
Methylibium sp. Pch-M	2082386	S	47	80	127	0.00042
Methylibium petroleiphilum	105560	S	50	68	118	0.00039
Sphaerotilus sp. FB-5	2914710	S	89	77	166	0.00055
Sphaerotilus sulfidivorans	639200	S	66	48	114	0.00038
Caldimonas thermodepolymerans	215580	S	78	89	167	0.00055
Caldimonas brevitalea	413882	S	71	23	94	0.00031
Rubrivivax gelatinosus	28068	S	147	94	241	0.00079
Roseateles sp. BIM B-1768	2978473	S	32	13	45	0.00015
Roseateles sp. SL47	2995138	S	20	8	28	0.00009
Roseateles depolymerans	76731	S	39	19	58	0.00019
Schlegelella aquatica	376175	S	71	52	123	0.00040
Mitsuaria sp. 7	1658665	S	50	23	73	0.00024
Ideonella dechloratans	36863	S	47	52	99	0.00033
Inhella inkyongensis	392593	S	26	7	33	0.00011
Achromobacter xylosoxidans	85698	S	59	111	170	0.00056
Achromobacter sp. AONIH1	1758194	S	21	31	52	0.00017
Achromobacter sp. MFA1 R4	1881016	S	14	14	28	0.00009
Achromobacter spanius	217203	S	40	22	62	0.00020
Achromobacter denitrificans	32002	S	25	29	54	0.00018
Achromobacter deleyi	1353891	S	24	28	52	0.00017
Achromobacter pestifer	1353889	S	14	18	32	0.00011
Achromobacter insolitus	217204	S	13	7	20	0.00007
Bordetella sp. N	1746199	S	32	9	41	0.00013
Bordetella sp. H567	1697043	S	16	6	22	0.00007
Bordetella flabilis	463014	S	29	8	37	0.00012
Bordetella petrii	94624	S	27	40	67	0.00022
Bordetella bronchialis	463025	S	24	12	36	0.00012
Bordetella hinzii	103855	S	21	36	57	0.00019
Bordetella genomosp. 13	463040	S	21	19	40	0.00013
Bordetella genomosp. 9	1416803	S	19	9	28	0.00009
Bordetella genomosp. 8	1416806	S	19	9	28	0.00009
Bordetella pseudohinzii	1331258	S	14	27	41	0.00013
Pigmentiphaga sp. H8	2488560	S	52	13	65	0.00021
Pigmentiphaga aceris	1940612	S	24	3	27	0.00009
Pusillimonas sp. M17	2962065	S	17	4	21	0.00007
Pusillimonas thiosulfatoxidans	2028345	S	12	3	15	0.00005
Alcaligenes faecalis	511	S	16	15	31	0.00010
Castellaniella defragrans	75697	S	25	18	43	0.00014
Orrella dioscoreae	1851544	S	16	8	24	0.00008
Kerstersia gyiorum	206506	S	10	2	12	0.00004
Rhizobacter sp. AJA081-3	2753607	S	204	121	325	0.00107
Rhizobacter gummiphilus	946333	S	146	66	212	0.00070
Aquabacterium sp. J223	2898431	S	121	83	204	0.00067
Aquabacterium olei	1296669	S	74	36	110	0.00036
Leptothrix cholodnii	34029	S	94	64	158	0.00052
Xylophilus rhododendri	2697032	S	82	49	131	0.00043
Thiomonas sp. X19	1050370	S	28	15	43	0.00014
Thiomonas intermedia	926	S	26	14	40	0.00013
Tepidimonas taiwanensis	307486	S	32	21	53	0.00017
Paucibacter sp. KCTC 42545	1768242	S	24	7	31	0.00010
Thauera sp. MZ1T	85643	S	39	44	83	0.00027
Thauera sp. K11	2005884	S	23	19	42	0.00014
Thauera sp. WB-2	2897772	S	11	8	19	0.00006
Thauera chlorobenzoica	96773	S	16	20	36	0.00012
Thauera humireducens	1134435	S	14	9	23	0.00008
Thauera aromatica	59405	S	12	22	34	0.00011
Azoarcus sp. KH32C	748247	S	22	9	31	0.00010
Azoarcus sp. DD4	2027405	S	19	20	39	0.00013
Azoarcus olearius	418699	S	21	14	35	0.00012
Nitrogeniibacter mangrovi	2016596	S	22	7	29	0.00010
Nitrogeniibacter aestuarii	2815343	S	13	2	15	0.00005
Parazoarcus communis	41977	S	25	11	36	0.00012
Pseudazoarcus pumilus	2067960	S	21	9	30	0.00010
Dechloromonas sp. A34	447588	S	30	10	40	0.00013
Dechloromonas sp. HYN0024	2231055	S	14	4	18	0.00006
Dechloromonas denitrificans	281362	S	34	16	50	0.00016
Ferribacterium limneticum	76259	S	73	20	93	0.00031
Quatrionicoccus australiensis	138118	S	12	5	17	0.00006
Aromatoleum aromaticum	551760	S	22	20	42	0.00014
Aromatoleum bremense	76115	S	16	13	29	0.00010
Aromatoleum petrolei	76116	S	10	4	14	0.00005
Azospira restricta	404405	S	37	37	74	0.00024
Niveibacterium microcysteis	2811415	S	21	4	25	0.00008
Oryzomicrobium terrae	1735038	S	15	5	20	0.00007
Chromobacterium sp. ATCC 53434	2059672	S	11	18	29	0.00010
Chromobacterium vaccinii	1108595	S	10	29	39	0.00013
Jeongeupia sp. USM3	1906741	S	13	8	21	0.00007
Vogesella sp. LIG4	1192162	S	13	9	22	0.00007
Pseudogulbenkiania sp. NH8B	748280	S	14	9	23	0.00008
Laribacter hongkongensis	168471	S	12	8	20	0.00007
Crenobacter cavernae	2290923	S	23	17	40	0.00013
Vitreoscilla filiformis	63	S	12	7	19	0.00006
Usitatibacter rugosus	2732067	S	43	7	50	0.00016
Usitatibacter palustris	2732487	S	36	6	42	0.00014
Sulfuritalea hydrogenivorans	748811	S	27	8	35	0.00012
Denitratisoma sp. DHT3	1981880	S	12	9	21	0.00007
Methyloversatilis sp. RAC08	1842540	S	13	3	16	0.00005
Sterolibacterium denitrificans	157592	S	10	5	15	0.00005
Ferriphaselus amnicola	1188319	S	10	4	14	0.00005
Thiobacillus denitrificans	36861	S	14	4	18	0.00006
Sulfuritortus calidifontis	1914471	S	13	8	21	0.00007
Casimicrobium huifangae	2591109	S	15	6	21	0.00007
Thermomonas aquatica	2202149	S	714	691	1405	0.00463
Thermomonas sp. HDW16	2714945	S	469	292	761	0.00251
Thermomonas sp. XSG	2771436	S	175	161	336	0.00111
Thermomonas carbonis	1463158	S	554	262	816	0.00269
Thermomonas brevis	215691	S	179	166	345	0.00114
Thermomonas paludicola	2884874	S	117	64	181	0.00060
Lysobacter sp. TY2-98	2290922	S	130	41	171	0.00056
Lysobacter sp. 5GHs7-4	2904253	S	64	41	105	0.00035
Lysobacter sp. CW239	2762611	S	60	47	107	0.00035
Lysobacter sp. KIS68-7	2904252	S	60	23	83	0.00027
Lysobacter sp. S4-A87	2925843	S	38	28	66	0.00022
Lysobacter sp. K5869	2820808	S	22	24	46	0.00015
Lysobacter sp. H21R4	2781021	S	13	51	64	0.00021
Lysobacter sp. HDW10	2714936	S	10	1	11	0.00004
Lysobacter sp. H23M47	2781024	S	10	95	105	0.00035
Lysobacter lycopersici	1324796	S	109	50	159	0.00052
Lysobacter oculi	2698682	S	107	57	164	0.00054
Lysobacter enzymogenes	69	S	102	86	188	0.00062
Lysobacter soli	453783	S	99	46	145	0.00048
Lysobacter terrestris	2865112	S	94	58	152	0.00050
Lysobacter maris	1605891	S	76	39	115	0.00038
Lysobacter capsici	435897	S	71	149	220	0.00072
Lysobacter luteus	2822368	S	68	33	101	0.00033
Lysobacter solisilvae	2763317	S	68	27	95	0.00031
Lysobacter alkalisoli	2591633	S	57	22	79	0.00026
Lysobacter arenosi	2795387	S	47	35	82	0.00027
Lysobacter antibioticus	84531	S	39	18	57	0.00019
Lysobacter ciconiae	2781022	S	22	85	107	0.00035
Stenotrophomonas maltophilia	40324	S	229	470	699	0.00230
Stenotrophomonas sp. SAU14A_NAIMI4_5	2072413	S	13	31	44	0.00014
Stenotrophomonas sp. ESTM1D_MKCIP4_1	2072414	S	11	18	29	0.00010
Stenotrophomonas sp. 169	2770322	S	68	24	92	0.00030
Stenotrophomonas sp. LM091	1904944	S	52	41	93	0.00031
Stenotrophomonas sp. 364	2691571	S	19	16	35	0.00012
Stenotrophomonas rhizophila	216778	S	106	70	176	0.00058
Stenotrophomonas acidaminiphila	128780	S	23	78	101	0.00033
Xanthomonas sp. AM6	2982531	S	15	25	40	0.00013
Xanthomonas sp. CFBP 8445	2971236	S	14	22	36	0.00012
Xanthomonas sp. SS	2724122	S	10	38	48	0.00016
Xanthomonas campestris	339	S	65	93	158	0.00052
Xanthomonas translucens	343	S	54	196	250	0.00082
Xanthomonas sacchari	56458	S	46	55	101	0.00033
Xanthomonas hortorum	56454	S	26	50	76	0.00025
Xanthomonas oryzae	347	S	19	13	32	0.00011
Xanthomonas theicola	56464	S	18	18	36	0.00012
Xanthomonas arboricola	56448	S	16	42	58	0.00019
Xanthomonas vesicatoria	56460	S	12	17	29	0.00010
Xanthomonas fragariae	48664	S	11	24	35	0.00012
Xanthomonas hyacinthi	56455	S	10	17	27	0.00009
Xanthomonas vasicola	56459	S	10	7	17	0.00006
Luteimonas sp. MC1750	2799326	S	61	39	100	0.00033
Luteimonas sp. JM171	1896164	S	49	19	68	0.00022
Luteimonas sp. MC1825	2761107	S	44	36	80	0.00026
Luteimonas sp. MC1572	2799325	S	41	33	74	0.00024
Luteimonas sp. S4-F44	2925842	S	40	16	56	0.00018
Luteimonas sp. YGD11-2	2508168	S	38	28	66	0.00022
Luteimonas fraxinea	2901869	S	130	62	192	0.00063
Luteimonas granuli	1176533	S	64	41	105	0.00035
Luteimonas yindakuii	2565782	S	36	24	60	0.00020
Luteimonas chenhongjianii	2006110	S	34	14	48	0.00016
Pseudoxanthomonas sp. SL93	2995142	S	51	26	77	0.00025
Pseudoxanthomonas sp. X-1	2571115	S	41	44	85	0.00028
Pseudoxanthomonas sp. JBR18	2969308	S	31	12	43	0.00014
Pseudoxanthomonas suwonensis	314722	S	77	59	136	0.00045
Pseudoxanthomonas mexicana	128785	S	60	126	186	0.00061
Pseudoxanthomonas daejeonensis	266062	S	50	30	80	0.00026
Pseudoxanthomonas spadix	415229	S	39	27	66	0.00022
Arenimonas daejeonensis	370777	S	78	29	107	0.00035
Pseudolysobacter antarcticus	2511995	S	14	0	14	0.00005
Luteibacter sp. 321	2911537	S	19	7	26	0.00009
Luteibacter sp. 335	2911538	S	14	4	18	0.00006
Luteibacter sp. 353	2911539	S	13	5	18	0.00006
Luteibacter pinisoli	2589080	S	18	7	25	0.00008
Luteibacter rhizovicinus	242606	S	12	2	14	0.00005
Luteibacter flocculans	2780091	S	10	2	12	0.00004
Rhodanobacter denitrificans	666685	S	25	19	44	0.00014
Rhodanobacter sp. FDAARGOS 1247	2778082	S	15	8	23	0.00008
Dyella thiooxydans	445710	S	21	10	31	0.00010
Dyella terrae	522259	S	13	2	15	0.00005
Dyella japonica	231455	S	10	3	13	0.00004
Frateuria edaphi	2898793	S	17	9	26	0.00009
Frateuria soli	1542730	S	12	8	20	0.00007
Dokdonella koreensis	323415	S	32	8	40	0.00013
Tahibacter sp. W38	2976241	S	16	1	17	0.00006
Aerosticca soli	2010829	S	11	12	23	0.00008
Pseudomonas sp. J452	2898441	S	30	17	47	0.00015
Pseudomonas sp. MM227	3019968	S	29	10	39	0.00013
Pseudomonas sp. CIP-10	2892442	S	23	378	401	0.00132
Pseudomonas sp. KU26590	2991051	S	22	10	32	0.00011
Pseudomonas sp. 15A4	2804761	S	20	21	41	0.00013
Pseudomonas sp. MTM4	2705472	S	16	9	25	0.00008
Pseudomonas sp. NIBR-H-19	2901380	S	14	13	27	0.00009
Pseudomonas sp. T1-3-2	2908006	S	11	4	15	0.00005
Pseudomonas trivialis	200450	S	55	36	91	0.00030
Pseudomonas fluorescens	294	S	53	74	127	0.00042
Pseudomonas poae	200451	S	35	35	70	0.00023
Pseudomonas orientalis	76758	S	30	15	45	0.00015
Pseudomonas congelans	200452	S	12	7	19	0.00006
Pseudomonas azotoformans	47878	S	10	16	26	0.00009
Pseudomonas putida	303	S	87	199	286	0.00094
Pseudomonas oryzihabitans	47885	S	45	33	78	0.00026
Pseudomonas fulva	47880	S	21	56	77	0.00025
Pseudomonas aeruginosa	287	S	43	440	483	0.00159
Pseudomonas alcaligenes	43263	S	28	21	49	0.00016
Pseudomonas citronellolis	53408	S	11	22	33	0.00011
Pseudomonas syringae	317	S	33	77	110	0.00036
Pseudomonas viridiflava	33069	S	11	2	13	0.00004
Pseudomonas rhizosphaerae	216142	S	52	13	65	0.00021
Pseudomonas chlororaphis	587753	S	21	27	48	0.00016
Pseudomonas fragi	296	S	12	11	23	0.00008
Pseudomonas campi	2731681	S	29	12	41	0.00013
Pseudomonas psychrotolerans	237610	S	26	12	38	0.00013
Pseudomonas knackmussii	65741	S	19	17	36	0.00012
Pseudomonas graminis	158627	S	16	9	25	0.00008
Pseudomonas otitidis	319939	S	15	6	21	0.00007
Pseudomonas siliginis	2842346	S	14	32	46	0.00015
Pseudomonas tritici	2745518	S	13	8	21	0.00007
Pseudomonas guangdongensis	1245526	S	13	7	20	0.00007
Pseudomonas phytophila	2867264	S	13	1	14	0.00005
Pseudomonas oryzae	1392877	S	12	6	18	0.00006
Pseudomonas entomophila	312306	S	10	8	18	0.00006
Pseudomonas saudiphocaensis	1499686	S	10	2	12	0.00004
Stutzerimonas stutzeri	316	S	69	105	174	0.00057
Stutzerimonas balearica	74829	S	10	12	22	0.00007
Azotobacter chroococcum	353	S	16	11	27	0.00009
Azotobacter salinestris	69964	S	13	9	22	0.00007
Azotobacter vinelandii	354	S	12	0	12	0.00004
Acinetobacter johnsonii	40214	S	195	251	446	0.00147
Acinetobacter lwoffii	28090	S	169	311	480	0.00158
Acinetobacter sp. CS-2	2798861	S	33	26	59	0.00019
Acinetobacter sp. WY4	2708348	S	11	32	43	0.00014
Acinetobacter junii	40215	S	63	25	88	0.00029
Acinetobacter calcoaceticus	471	S	16	3	19	0.00006
Acinetobacter baumannii	470	S	12	104	116	0.00038
Acinetobacter pittii	48296	S	12	18	30	0.00010
Acinetobacter schindleri	108981	S	29	20	49	0.00016
Acinetobacter pseudolwoffii	2053287	S	23	40	63	0.00021
Acinetobacter indicus	756892	S	19	10	29	0.00010
Acinetobacter wuhouensis	1879050	S	13	7	20	0.00007
Acinetobacter piscicola	2006115	S	12	6	18	0.00006
Moraxella osloensis	34062	S	133	20	153	0.00050
Psychrobacter sanguinis	861445	S	14	17	31	0.00010
Pantoea agglomerans	549	S	255	93	348	0.00115
Pantoea dispersa	59814	S	13	4	17	0.00006
Buchnera aphidicola	9	S	52	7	59	0.00019
Duffyella gerundensis	1619313	S	13	2	15	0.00005
Leclercia sp. 29361	2714951	S	21	33	54	0.00018
Leclercia adecarboxylata	83655	S	17	23	40	0.00013
Lelliottia amnigena	61646	S	13	6	19	0.00006
Escherichia coli	562	S	14	212	226	0.00074
Serratia marcescens	615	S	10	49	59	0.00019
Serratia plymuthica	82996	S	10	15	25	0.00008
Rahnella aquatilis	34038	S	10	9	19	0.00006
Morganella morganii	582	S	26	16	42	0.00014
Providencia rettgeri	587	S	10	15	25	0.00008
Halomonas sp. JS92-SW72	2306583	S	29	80	109	0.00036
Halomonas sp. DN3	2953657	S	18	14	32	0.00011
Alcanivorax sp. ALC70	2259335	S	10	9	19	0.00006
Alloalcanivorax dieselolei	285091	S	10	3	13	0.00004
Thioalkalivibrio nitratireducens	186931	S	10	7	17	0.00006
Spiribacter sp. E85	2182432	S	14	2	16	0.00005
Alkalilimnicola ehrlichii	351052	S	10	1	11	0.00004
Rheinheimera sp. MM224	3019969	S	18	2	20	0.00007
Marichromatium purpuratum	37487	S	14	5	19	0.00006
Thioflavicoccus mobilis	80679	S	12	2	14	0.00005
Wenzhouxiangella marina	1579979	S	12	1	13	0.00004
Sulfurivermis fontis	1972068	S	14	7	21	0.00007
Aeromonas media	651	S	24	34	58	0.00019
Aeromonas salmonicida	645	S	22	38	60	0.00020
Aeromonas veronii	654	S	17	47	64	0.00021
Aeromonas hydrophila	644	S	16	43	59	0.00019
Aeromonas encheleia	73010	S	14	6	20	0.00007
Immundisolibacter cernigliae	1810504	S	163	39	202	0.00067
Cellvibrio sp. QJXJ	2964606	S	15	20	35	0.00012
Kineobactrum salinum	2708301	S	15	1	16	0.00005
Methylomagnum ishizawai	1760988	S	14	4	18	0.00006
Solimonas sp. K1W22B-7	2303331	S	24	3	27	0.00009
Flagellatimonas centrodinii	2806210	S	16	1	17	0.00006
Steroidobacter denitrificans	465721	S	13	3	16	0.00005
Sulfurifustis variabilis	1675686	S	22	2	24	0.00008
Sulfuricaulis limicola	1620215	S	10	1	11	0.00004
Pasteurella multocida	747	S	18	90	108	0.00036
Salinisphaera sp. LB1	2183911	S	10	0	10	0.00003
Hymenobacter sp. S2-20-2	2761579	S	345	44	389	0.00128
Hymenobacter sp. HDW8	2714932	S	259	230	489	0.00161
Hymenobacter sp. 5317J-9	2932250	S	202	32	234	0.00077
Hymenobacter sp. PAMC 29467	2999067	S	107	40	147	0.00048
Hymenobacter sp. BRD128	2675878	S	105	11	116	0.00038
Hymenobacter sp. BT18	2835648	S	101	11	112	0.00037
Hymenobacter sp. 5116S-3	2932248	S	89	12	101	0.00033
Hymenobacter sp. DG25A	1385663	S	87	29	116	0.00038
Hymenobacter sp. 5420S-77	2932254	S	86	5	91	0.00030
Hymenobacter sp. DG01	2584940	S	83	23	106	0.00035
Hymenobacter sp. DG25B	1385664	S	78	25	103	0.00034
Hymenobacter sp. 5116S-27	2932249	S	72	10	82	0.00027
Hymenobacter sp. YIM 151500-1	2987689	S	69	8	77	0.00025
Hymenobacter sp. PAMC 26628	1484118	S	68	10	78	0.00026
Hymenobacter sp. NBH84	2596915	S	62	8	70	0.00023
Hymenobacter sp. APR13	1356852	S	60	53	113	0.00037
Hymenobacter sp. 5413J-13	2932251	S	55	7	62	0.00020
Hymenobacter sp. 5516S-25	2933777	S	52	144	196	0.00065
Hymenobacter sp. YIM 151858-1	2987688	S	45	6	51	0.00017
Hymenobacter sp. BRD67	2675877	S	37	11	48	0.00016
Hymenobacter sp. 5516J-16	2932253	S	24	73	97	0.00032
Hymenobacter qilianensis	1385715	S	333	27	360	0.00119
Hymenobacter radiodurans	2496028	S	240	229	469	0.00154
Hymenobacter monticola	1705399	S	213	20	233	0.00077
Hymenobacter sedentarius	1411621	S	166	15	181	0.00060
Hymenobacter psoromatis	1484116	S	73	5	78	0.00026
Hymenobacter swuensis	1446467	S	62	7	69	0.00023
Hymenobacter tibetensis	497967	S	53	3	56	0.00018
Hymenobacter busanensis	2607656	S	47	4	51	0.00017
Hymenobacter yonginensis	748197	S	42	24	66	0.00022
Hymenobacter nivis	1850093	S	42	5	47	0.00015
Hymenobacter jejuensis	2502781	S	36	2	38	0.00013
Hymenobacter baengnokdamensis	2615203	S	31	10	41	0.00013
Hymenobacter oligotrophus	2319843	S	28	3	31	0.00010
Rufibacter sp. DG15C	1379909	S	105	26	131	0.00043
Rufibacter radiotolerans	1379910	S	96	12	108	0.00036
Rufibacter tibetensis	512763	S	29	4	33	0.00011
Pontibacter russatus	2694929	S	65	8	73	0.00024
Pontibacter pudoricolor	2694930	S	29	3	32	0.00011
Pontibacter actiniarum	323450	S	14	23	37	0.00012
Nibribacter ruber	2698458	S	73	14	87	0.00029
Adhaeribacter radiodurans	2745197	S	37	3	40	0.00013
Adhaeribacter swui	2086471	S	29	2	31	0.00010
Dyadobacter sp. CY22	2909339	S	117	11	128	0.00042
Dyadobacter sp. NIV53	2861765	S	17	1	18	0.00006
Dyadobacter sp. LJ419	2906456	S	16	1	17	0.00006
Fibrella sp. ES10-3-2-2	1834519	S	28	3	31	0.00010
Runella rosea	2259595	S	15	0	15	0.00005
Spirosoma sp. KCTC 72228	2710596	S	15	3	18	0.00006
Spirosoma sp. KCTC 42546	2520506	S	12	2	14	0.00005
Spirosoma sp. RHs26	2898794	S	11	1	12	0.00004
Spirosoma rigui	564064	S	26	5	31	0.00010
Spirosoma pollinicola	2057025	S	25	6	31	0.00010
Spirosoma taeanense	2735870	S	15	3	18	0.00006
Spirosoma rhododendri	2728024	S	11	1	12	0.00004
Rhodocytophaga rosea	2704465	S	48	1	49	0.00016
Tellurirhabdus rosea	2674997	S	12	1	13	0.00004
Chryseolinea soli	2321403	S	10	0	10	0.00003
Flavobacterium sp. N2820	2986834	S	174	84	258	0.00085
Flavobacterium sp. IMCC36791	3003262	S	34	13	47	0.00015
Flavobacterium sp. IMCC34775	3003258	S	28	15	43	0.00014
Flavobacterium sp. M31R6	2739062	S	21	14	35	0.00012
Flavobacterium sp. N1994	2986827	S	20	5	25	0.00008
Flavobacterium sp. IMCC36793	3003263	S	16	7	23	0.00008
Flavobacterium sp. KK2020170	2830782	S	15	9	24	0.00008
Flavobacterium sp. SLB02	2665645	S	15	23	38	0.00013
Flavobacterium sp. F-29	2893883	S	13	7	20	0.00007
Flavobacterium sp. N1846	2986824	S	12	4	16	0.00005
Flavobacterium sp. F-70	2893884	S	11	8	19	0.00006
Flavobacterium sp. IMCC36792	3016339	S	10	5	15	0.00005
Flavobacterium sp. MMS21-Er5	2937442	S	10	14	24	0.00008
Flavobacterium sp. N2038	2986829	S	10	10	20	0.00007
Flavobacterium sp. N2270	2986831	S	10	5	15	0.00005
Flavobacterium sp. MDT1-60	1979344	S	10	8	18	0.00006
Flavobacterium cyclinae	2895947	S	113	70	183	0.00060
Flavobacterium channae	2897181	S	111	87	198	0.00065
Flavobacterium commune	1306519	S	77	27	104	0.00034
Flavobacterium sangjuense	2518177	S	44	9	53	0.00017
Flavobacterium haoranii	683124	S	19	15	34	0.00011
Flavobacterium nackdongense	2547394	S	16	3	19	0.00006
Flavobacterium fluviale	2249356	S	15	13	28	0.00009
Flavobacterium ammonificans	1751056	S	14	7	21	0.00007
Flavobacterium psychrophilum	96345	S	14	4	18	0.00006
Flavobacterium azooxidireducens	1871076	S	14	2	16	0.00005
Flavobacterium indicum	312277	S	13	3	16	0.00005
Flavobacterium anhuiense	459526	S	13	14	27	0.00009
Flavobacterium pallidum	2172098	S	11	1	12	0.00004
Antarcticibacterium arcticum	2585771	S	20	5	25	0.00008
Antarcticibacterium sp. 1MA-6-2	2908210	S	16	4	20	0.00007
Myroides odoratus	256	S	14	12	26	0.00009
Chryseobacterium sp. KACC 21268	3025664	S	72	9	81	0.00027
Chryseobacterium sp. CX-624	2758037	S	49	10	59	0.00019
Chryseobacterium sp. CY350	2997336	S	24	8	32	0.00011
Chryseobacterium sp.	1871047	S	21	8	29	0.00010
Chryseobacterium sp. 6424	2039166	S	17	7	24	0.00008
Chryseobacterium sp. 3008163	2478663	S	17	14	31	0.00010
Chryseobacterium sp. LJ668	2864040	S	14	4	18	0.00006
Chryseobacterium sp. POL2	2713414	S	10	6	16	0.00005
Chryseobacterium faecale	2852098	S	145	27	172	0.00057
Chryseobacterium indoltheticum	254	S	42	26	68	0.00022
Chryseobacterium manosquense	2754694	S	21	26	47	0.00015
Chryseobacterium taklimakanense	536441	S	21	17	38	0.00013
Chryseobacterium suipulveris	2929800	S	15	7	22	0.00007
Chryseobacterium turcicum	2898076	S	15	11	26	0.00009
Chryseobacterium indologenes	253	S	14	13	27	0.00009
Chryseobacterium balustinum	246	S	13	11	24	0.00008
Chryseobacterium salivictor	2547600	S	11	2	13	0.00004
Kaistella daneshvariae	2487074	S	122	20	142	0.00047
Kaistella sp. BT6-1-3	2989820	S	41	38	79	0.00026
Kaistella sp. GW4-15	2878534	S	11	2	13	0.00004
Epilithonimonas vandammei	2487072	S	13	22	35	0.00012
Cloacibacterium caeni	2004710	S	48	44	92	0.00030
Empedobacter falsenii	343874	S	15	8	23	0.00008
Empedobacter stercoris	1628248	S	11	5	16	0.00005
Pseudocnuella soli	2502779	S	462	86	548	0.00180
Flavisolibacter ginsenosidimutans	661481	S	54	6	60	0.00020
Flavisolibacter tropicus	1492898	S	54	13	67	0.00022
Chitinophaga sp. R8	2920382	S	11	9	20	0.00007
Chitinophaga sp. XS-30	2604421	S	10	6	16	0.00005
Chitinophaga oryzae	2725414	S	10	12	22	0.00007
Lacibacter sp. S13-6-22	2760713	S	51	5	56	0.00018
Phnomibacter ginsenosidimutans	2676868	S	51	8	59	0.00019
Arachidicoccus sp. BS20	1850526	S	12	5	17	0.00006
Arachidicoccus ginsenosidivorans	496057	S	11	1	12	0.00004
Arachidicoccus soli	2341117	S	11	1	12	0.00004
Flavihumibacter rivuli	2838156	S	25	4	29	0.00010
Flavihumibacter fluminis (ex Park et al. 2022)	2838157	S	13	1	14	0.00005
Ferruginibacter lapsinanis	563172	S	22	4	26	0.00009
Ferruginibacter albus	2875540	S	13	2	15	0.00005
Niabella soli	446683	S	17	7	24	0.00008
Niastella koreensis	354356	S	28	4	32	0.00011
Panacibacter ginsenosidivorans	1813871	S	25	2	27	0.00009
Filimonas lacunae	477680	S	23	3	26	0.00009
Paraflavitalea soli	2315862	S	23	2	25	0.00008
Pseudobacter ginsenosidimutans	661488	S	14	1	15	0.00005
Pedobacter sp. G11	2482728	S	65	21	86	0.00028
Pedobacter sp. D749	2856523	S	24	22	46	0.00015
Pedobacter sp. HDW13	2714940	S	11	3	14	0.00005
Pedobacter mucosus	2895286	S	14	3	17	0.00006
Pedobacter roseus	336820	S	12	8	20	0.00007
Pedobacter cryoconitis	188932	S	10	2	12	0.00004
Pedobacter schmidteae	2201271	S	10	2	12	0.00004
Pedobacter riviphilus	2766984	S	10	5	15	0.00005
Phocaeicola vulgatus	821	S	13	29	42	0.00014
Prevotella copri	165179	S	25	10	35	0.00012
Rhodothermus marinus	29549	S	28	2	30	0.00010
Rhodocaloribacter litoris	2558931	S	23	2	25	0.00008
Salinibacter ruber	146919	S	12	0	12	0.00004
Gemmatirosa kalamazoonensis	861299	S	233	29	262	0.00086
Gemmatimonas groenlandica	2732249	S	51	6	57	0.00019
Gemmatimonas aurantiaca	173480	S	26	3	29	0.00010
Gemmatimonas phototrophica	1379270	S	23	3	26	0.00009
Urbifossiella limnaea	2528023	S	158	21	179	0.00059
Gemmata obscuriglobus	114	S	45	6	51	0.00017
Gemmata massiliana	1210884	S	18	11	29	0.00010
Gemmata sp. SH-PL17	1630693	S	17	11	28	0.00009
Frigoriglobus tundricola	2774151	S	67	14	81	0.00027
Limnoglobus roseus	2598579	S	35	2	37	0.00012
Tautonia plasticadhaerens	2527974	S	120	22	142	0.00047
Aquisphaera giovannonii	406548	S	71	20	91	0.00030
Paludisphaera borealis	1387353	S	52	19	71	0.00023
Singulisphaera acidiphila	466153	S	42	7	49	0.00016
Isosphaera pallida	128	S	10	0	10	0.00003
Planctomyces sp. SH-PL62	1636152	S	105	47	152	0.00050
Planctomyces sp. SH-PL14	1632864	S	13	1	14	0.00005
Caulifigura coniformis	2527983	S	25	3	28	0.00009
Alienimonas californiensis	2527989	S	20	2	22	0.00007
Maioricimonas rarisocia	2528026	S	16	3	19	0.00006
Lignipirellula cremea	2528010	S	11	5	16	0.00005
Lacipirellula limnantheis	2528024	S	35	7	42	0.00014
Lacipirellula parvula	2650471	S	16	4	20	0.00007
Botrimarina mediterranea	2528022	S	19	3	22	0.00007
Pirellulimonas nuda	2528009	S	14	3	17	0.00006
Humisphaera borealis	2807512	S	52	1	53	0.00017
Phycisphaera mikurensis	547188	S	15	1	16	0.00005
Opitutus terrae	107709	S	21	2	23	0.00008
Opitutus sp. GAS368	1882749	S	17	6	23	0.00008
Nibricoccus aquaticus	2576891	S	20	2	22	0.00007
Lacunisphaera limnophila	1838286	S	12	4	16	0.00005
Ereboglobus luteus	1796921	S	10	1	11	0.00004
Luteolibacter ambystomatis	2824561	S	21	4	25	0.00008
Luteolibacter luteus	2728835	S	19	2	21	0.00007
Luteolibacter sp. SL250	2995170	S	15	2	17	0.00006
Verrucomicrobium sp. GAS474	1882831	S	13	1	14	0.00005
Verrucomicrobium spinosum	2736	S	11	1	12	0.00004
Anaeromyxobacter oryzae	2918170	S	83	14	97	0.00032
Anaeromyxobacter sp. Fw109-5	404589	S	58	12	70	0.00023
Anaeromyxobacter paludicola	2918171	S	58	12	70	0.00023
Anaeromyxobacter dehalogenans	161493	S	38	96	134	0.00044
Corallococcus sp. EGB	1521117	S	16	7	23	0.00008
Corallococcus sp. NCRR	2996782	S	15	11	26	0.00009
Corallococcus macrosporus	35	S	24	23	47	0.00015
Corallococcus coralloides	184914	S	22	15	37	0.00012
Myxococcus xanthus	34	S	22	37	59	0.00019
Myxococcus sp. SCHIC003	2813577	S	15	5	20	0.00007
Myxococcus stipitatus	83455	S	11	3	14	0.00005
Myxococcus hansupus	1297742	S	10	4	14	0.00005
Pyxidicoccus sp. SCPEA002	2813578	S	40	10	50	0.00016
Archangium violaceum	83451	S	42	16	58	0.00019
Archangium gephyra	48	S	28	12	40	0.00013
Cystobacter fuscus	43	S	36	18	54	0.00018
Stigmatella aurantiaca	41	S	30	8	38	0.00013
Vulgatibacter incomptus	1391653	S	25	2	27	0.00009
Sorangium cellulosum	56	S	134	102	236	0.00078
Polyangium aurulentum	2567896	S	37	5	42	0.00014
Chondromyces crocatus	52	S	22	1	23	0.00008
Sandaracinus amylolyticus	927083	S	87	12	99	0.00033
Labilithrix luteola	1391654	S	44	3	47	0.00015
Nannocystis sp. fl3	2995304	S	60	5	65	0.00021
Haliangium ochraceum	80816	S	34	3	37	0.00012
Luteitalea sp. TBR-22	2802971	S	331	70	401	0.00132
Luteitalea pratensis	1855912	S	324	50	374	0.00123
Granulicella sp. WH15	2602070	S	14	4	18	0.00006
Edaphobacter sp. 12200R-103	2703788	S	11	3	14	0.00005
Acidobacterium capsulatum	33075	S	11	2	13	0.00004
Candidatus Koribacter versatilis	658062	S	10	0	10	0.00003
Acidisarcina polymorpha	2211140	S	10	2	12	0.00004
Paludibaculum fermentans	1473598	S	22	1	23	0.00008
Sulfidibacter corallicola	2818388	S	12	0	12	0.00004
Geobacter sp. FeAm09	2597769	S	14	10	24	0.00008
Geobacter sp. SVR	2495594	S	10	6	16	0.00005
Geomonas nitrogeniifigens	2847991	S	13	25	38	0.00013
Geomonas sp. RF6	2897342	S	10	5	15	0.00005
Desulfuromonas versatilis	2802975	S	10	9	19	0.00006
Aliarcobacter cryaerophilus	28198	S	23	5	28	0.00009
Arcobacter suis	1278212	S	13	4	17	0.00006
Candidatus Saccharimonas aalborgensis	1332188	S	12	4	16	0.00005
Candidatus Mycosynbacter amalyticus	2665156	S	17	7	24	0.00008
Nitrospira moscoviensis	42253	S	12	6	18	0.00006
Persicimonas caeni	2292766	S	14	2	16	0.00005
Botrytis cinerea	40559	S	7064	381	7445	0.02451
Fusarium poae	36050	S	27	29	56	0.00018
Fusarium venenatum	56646	S	26	131	157	0.00052
Fusarium pseudograminearum	101028	S	26	38	64	0.00021
Fusarium falciforme	195108	S	19	33	52	0.00017
Fusarium musae	1042133	S	49	65	114	0.00038
Fusarium verticillioides	117187	S	28	38	66	0.00022
Fusarium fujikuroi	5127	S	10	1	11	0.00004
Fusarium oxysporum	5507	S	14	11	25	0.00008
Ustilaginoidea virens	1159556	S	76	20	96	0.00032
Pochonia chlamydosporia	280754	S	21	3	24	0.00008
Purpureocillium takamizusanense	2060973	S	36	17	53	0.00017
Drechmeria coniospora	98403	S	33	8	41	0.00013
Colletotrichum lupini	145971	S	66	33	99	0.00033
Colletotrichum higginsianum	80884	S	50	87	137	0.00045
Thermothelomyces thermophilus	78579	S	49	12	61	0.00020
Thermothielavioides terrestris	2587410	S	36	11	47	0.00015
Neurospora crassa	5141	S	60	22	82	0.00027
Pyricularia pennisetigena	1578925	S	14	4	18	0.00006
Pyricularia grisea	148305	S	12	4	16	0.00005
Pyricularia oryzae	318829	S	11	5	16	0.00005
Aspergillus chevalieri	182096	S	609	256	865	0.00285
Aspergillus nidulans	162425	S	145	37	182	0.00060
Aspergillus oryzae	5062	S	30	128	158	0.00052
Aspergillus puulaauensis	1220207	S	108	33	141	0.00046
Aspergillus luchuensis	1069201	S	79	38	117	0.00039
Aspergillus fumigatus	746128	S	61	22	83	0.00027
Penicillium oxalicum	69781	S	19	9	28	0.00009
Talaromyces rugulosus	121627	S	41	8	49	0.00016
Cercospora beticola	122368	S	399	203	602	0.00198
Zymoseptoria tritici	1047171	S	211	174	385	0.00127
Fulvia fulva	5499	S	118	100	218	0.00072
Scheffersomyces stipitis	4924	S	17	11	28	0.00009
Brettanomyces nanus	13502	S	10	9	19	0.00006
Pichia kudriavzevii	4909	S	10	6	16	0.00005
Yarrowia lipolytica	4952	S	24	5	29	0.00010
Sugiyamaella lignohabitans	796027	S	11	6	17	0.00006
Schizosaccharomyces pombe	4896	S	12	3	15	0.00005
Psilocybe cubensis	181762	S	1627	638	2265	0.00746
Marasmius oreades	181124	S	1338	770	2108	0.00694
Rhizoctonia solani	456999	S	836	174	1010	0.00333
Puccinia triticina	208348	S	267	71	338	0.00111
Puccinia striiformis	27350	S	205	554	759	0.00250
Sporisorium graminicola	280036	S	172	80	252	0.00083
Ustilago maydis	5270	S	20	2	22	0.00007
Malassezia restricta	76775	S	42	16	58	0.00019
Homo sapiens	9606	S	4857	742	5599	0.01843
Theileria equi	5872	S	10	4	14	0.00005
Toxoplasma gondii	5811	S	14	2	16	0.00005
Phaeodactylum tricornutum	2850	S	14	5	19	0.00006
Salinirubellus salinus	1364945	S	11	40	51	0.00017
Methanosarcina mazei	2209	S	12	2	14	0.00005
Candidatus Nitrosocosmicus oleophilus	1353260	S	24	11	35	0.00012
